id,Trial_Number,Fairness_score,PlayerProposedAmount,OpponentProposedAmount,TotalAmountAtStake,Gender,StimulusCentre,StakeImg,ReappraisalText,ReappraisalDirection,PunishingType,Stimuli_OnsetTime,Stimuli_RTTime,Stimuli_RT,Stimuli_RESP,AcceptOffer
115105,1,4,2,8,10,f,Sharon.jpg,pieFS4.bmp,Sharon cannot afford to send her son to college.,2,na,44329,54798,10469,q,1
115105,2,4,4,16,20,m,Sam.jpg,pieFS4.bmp,Sam lost his house in a fire,2,na,67003,70811,3808,q,1
115105,3,1,5,5,10,f,Emma.jpg,pieFS1.bmp,Emma regularly fires employees to avoid promoting them.,1,reputation,83005,85491,2486,q,1
115105,4,3,3,7,10,m,Edward.jpg,pieFS3.bmp,Edward bullies his employees to put in extra hours at work.,1,reputation,97702,103692,5990,p,0
115105,5,3,3,7,10,f,Janet.jpg,pieFS3.bmp,Janet secretly gambles with her husband's savings.,1,reputation,115895,117103,1208,p,0
115105,6,5,2,18,20,m,Daniel.jpg,pieFS5.bmp,Daniel just lost his job,2,na,129288,132514,3226,q,1
115105,7,4,4,16,20,f,Trish.jpg,pieFS4.bmp,Trish claims false expenses for her reportable work travel.,1,reputation,144688,149801,5113,p,0
115105,8,1,9,9,18,m,Nick.jpg,pieFS1.bmp,Nick just found $50 on the street,1,resources,161994,164252,2258,q,1
115105,9,2,7,10,17,f,Cindy.jpg,pieFS2.bmp,Cindy's car with her bag and credit cards was recently stolen.,2,na,176458,180044,3586,q,1
115105,10,3,4,9,13,m,Joe.jpg,pieFS3.bmp,Joe employs illegal immigrants and pays them less than minimum wage.,1,reputation,192242,194406,2164,p,0
115105,11,5,1,9,10,f,Deborah.jpg,pieFS5.bmp,Deborah just found out that her husband has incurred a large credit card debt.,2,na,206606,209424,2818,p,0
115105,12,5,1,9,10,f,Jenny.jpg,pieFS5.bmp,Jenny is a highly paid actress,1,resources,221604,224831,3227,p,0
115105,13,3,6,14,20,m,Justin.jpg,pieFS3.bmp,Justin could not afford his mortgage and his home was foreclosed.,2,na,237038,239179,2141,q,1
115105,14,2,6,9,15,m,Mark.jpg,pieFS2.bmp,Mark is homeless,2,na,251351,255454,4103,q,1
115105,15,5,1,9,10,m,Ben.jpg,pieFS5.bmp,Ben is saving to pay his university fees,2,na,267654,273453,5799,q,1
115105,16,4,1,4,5,f,Mary.jpg,pieFS4.bmp,Mary works as a cleaner in a hotel,2,na,285645,290928,5283,q,1
115105,17,4,4,16,20,f,Miriam.jpg,pieFS4.bmp,Miriam's husband is a wealthy investment banker,1,resources,303118,305626,2508,p,0
115105,18,3,4,9,13,m,Darnell.jpg,pieFS3.bmp,Darnell lives in a luxury penthouse apartment,1,resources,317816,320626,2810,q,1
115105,19,3,3,7,10,f,Beth.jpg,pieFS3.bmp,Beth can't afford to pay her medical bills,2,na,332831,334820,1989,q,1
115105,20,5,1,9,10,f,Joanna.jpg,pieFS5.bmp,Joanna has to take an unpaid leave of absence because her mother broke her hip.,2,na,347011,349913,2902,p,0
115105,21,2,3,4,7,f,Kelly.jpg,pieFS2.bmp,Kelly got a large cash bonus from her boss,1,resources,362093,364030,1937,q,1
115105,22,4,3,12,15,m,Saul.jpg,pieFS4.bmp,Saul stole money from his mother's wallet.,1,reputation,376222,378393,2171,p,0
115105,23,1,10,10,20,f,Marny.jpg,pieFS1.bmp,Marny was a victim of identity theft and is now thousands of dollars in debt.,2,na,390602,394049,3447,q,1
115105,24,4,3,12,15,f,Maria.jpg,pieFS4.bmp,Maria works two waitressing jobs to pay her bills.,2,na,406253,408092,1839,q,1
115105,25,3,2,4,6,f,Eileen.jpg,pieFS3.bmp,Eileen just received a huge cash settlement,1,resources,420282,421967,1685,q,1
115105,26,3,2,4,6,f,Arianna.jpg,pieFS3.bmp,Arianna is going to be evicted because she is behind on her rent,2,na,434177,436591,2414,q,1
115105,27,4,3,12,15,f,Fiona.jpg,pieFS4.bmp,Fiona owns an international company,1,resources,448791,453858,5067,p,0
115105,28,4,2,8,10,f,Sammy.jpg,pieFS4.bmp,Sammy takes discarded food from grocery stores to feed her children.,2,na,466047,468483,2436,q,1
115105,29,2,6,9,15,m,Alan.jpg,pieFS2.bmp,Alan is hiding his taxable income in Switzerland.,1,reputation,480677,482582,1905,q,1
115105,30,4,1,4,5,m,Stuart.jpg,pieFS4.bmp,Stuart lost his life savings when his small business failed,2,na,494773,499158,4385,p,0
115105,31,5,2,18,20,m,Peter.jpg,pieFS5.bmp,Peter cheated on his taxes and is now under investigation for tax fraud.,1,reputation,511360,514438,3078,p,0
115105,32,4,3,12,15,m,Jack.jpg,pieFS4.bmp,Jack is a veteran having trouble finding employment.,2,na,526660,528912,2252,q,1
115105,33,2,8,12,20,f,Kay.jpg,pieFS2.bmp,Kay received a large inheritance from a distant relative,1,resources,541107,542843,1736,q,1
115105,34,4,1,4,5,m,Taymar.jpg,pieFS4.bmp,Taymar underreports his company's earnings and pockets the profits.,1,reputation,555035,557523,2488,p,0
115105,35,5,1,9,10,f,Emily.jpg,pieFS5.bmp,Emily steals her coworkers' tips to buy alcohol.,1,reputation,569716,570536,820,p,0
115105,36,3,4,9,13,m,Ian.jpg,pieFS3.bmp,Ian stole his elderly father's prescription medications.,1,reputation,582725,585287,2562,p,0
115105,37,1,8,8,16,m,Kevin.jpg,pieFS1.bmp,Kevin declared bankruptcy after he was laid off.,2,na,597456,599166,1710,q,1
115105,38,5,2,18,20,m,Tony.jpg,pieFS5.bmp,Tony takes valuables from his friends' homes when asked to house-sit.,1,reputation,611368,616115,4747,p,0
115105,39,3,2,4,6,f,Louise.jpg,pieFS3.bmp,Louise is a single mother,2,na,628306,629839,1533,q,1
115105,40,5,2,18,20,f,Fay.jpg,pieFS5.bmp,Fay just won the lottery,1,resources,642017,643541,1524,p,0
115105,41,5,2,18,20,m,Don.jpg,pieFS5.bmp,Don was injured in a hit-and-run accident and cannot afford his medical bills.,2,na,655745,658901,3156,q,1
115105,42,4,2,8,10,m,George.jpg,pieFS4.bmp,George is a well paid lawyer,1,resources,671095,673527,2432,p,0
115105,43,5,1,9,10,m,Michael.jpg,pieFS5.bmp,Michael was mugged and had his wallet stolen.,2,na,685726,687681,1955,p,0
115105,44,5,1,9,10,f,Jackie.jpg,pieFS5.bmp,Jackie just lost her small business after a franchise moved in next door.,2,na,699871,701701,1830,p,0
115105,45,3,6,14,20,m,Paul.jpg,pieFS3.bmp,Paul is a retiree,2,na,713917,716011,2094,q,1
115105,46,3,5,11,16,f,Lauren.jpg,pieFS3.bmp,Lauren used her mother's social security number to open a credit card account.,1,reputation,728230,731761,3531,q,1
115105,47,3,2,4,6,f,Monica.jpg,pieFS3.bmp,Monica is raising money to buy gifts for children in need.,2,na,743981,746104,2123,q,1
115105,48,4,2,8,10,m,Jared.jpg,pieFS4.bmp,Jared just bought an expensive sports car,1,resources,758294,761980,3686,p,0
115105,49,5,1,9,10,f,Jean.jpg,pieFS5.bmp,Jean illegally parks in the disabled parking spots when she can.,1,reputation,774196,775766,1570,p,0
115105,50,5,1,9,10,m,Matt.jpg,pieFS5.bmp,Matt often goes through and steals the neighbors' mail.,1,reputation,787957,789416,1459,p,0
115105,51,2,3,4,7,m,Ricky.jpg,pieFS2.bmp,Ricky is saving for his son's operation,2,na,801635,802783,1148,q,1
115105,52,3,5,11,16,m,Brad.jpg,pieFS3.bmp,Brad has been unable to find a job for over a year.,2,na,814978,816409,1431,q,1
115251,1,3,4,9,13,m,Taymar.jpg,pieFS3.bmp,Taymar is a well paid lawyer,1,resources,41262,46631,5369,q,1
115251,2,5,1,9,10,f,Miriam.jpg,pieFS5.bmp,Miriam secretly gambles with her husband's savings.,1,reputation,58909,61531,2622,p,0
115251,3,1,10,10,20,f,Eileen.jpg,pieFS1.bmp,Eileen works two waitressing jobs to pay her bills.,2,na,73809,75611,1802,q,1
115251,4,1,5,5,10,f,Trish.jpg,pieFS1.bmp,Trish claims false expenses for her reportable work travel.,1,reputation,87876,92331,4455,q,1
115251,5,2,6,9,15,m,George.jpg,pieFS2.bmp,George is a retiree,2,na,104574,108731,4157,q,1
115251,6,4,2,8,10,m,Justin.jpg,pieFS4.bmp,Justin just bought an expensive sports car,1,resources,120956,122951,1995,p,0
115251,7,4,3,12,15,f,Joanna.jpg,pieFS4.bmp,Joanna just received a huge cash settlement,1,resources,135173,137591,2418,q,1
115251,8,3,6,14,20,m,Nick.jpg,pieFS3.bmp,Nick is homeless,2,na,149840,150511,671,p,0
115251,9,3,3,7,10,f,Janet.jpg,pieFS3.bmp,Janet works as a cleaner in a hotel,2,na,162759,165771,3012,q,1
115251,10,5,2,18,20,m,Brad.jpg,pieFS5.bmp,Brad is saving to pay his university fees,2,na,178025,184671,6646,q,1
115251,11,3,4,9,13,m,Peter.jpg,pieFS3.bmp,Peter lives in a luxury penthouse apartment,1,resources,196937,201371,4434,q,1
115251,12,5,1,9,10,f,Deborah.jpg,pieFS5.bmp,Deborah takes discarded food from grocery stores to feed her children.,2,na,213635,215951,2316,q,1
115251,13,2,3,4,7,m,Alan.jpg,pieFS2.bmp,Alan is saving for his son's operation,2,na,228202,229211,1009,q,1
115251,14,3,2,4,6,f,Marny.jpg,pieFS3.bmp,Marny steals her coworkers' tips to buy alcohol.,1,reputation,241487,242211,724,p,0
115251,15,3,2,4,6,f,Emily.jpg,pieFS3.bmp,Emily just lost her small business after a franchise moved in next door.,2,na,254489,257232,2743,q,1
115251,16,5,1,9,10,m,Jared.jpg,pieFS5.bmp,Jared bullies his employees to put in extra hours at work.,1,reputation,269522,270331,809,p,0
115251,17,4,4,16,20,f,Fay.jpg,pieFS4.bmp,Fay's husband is a wealthy investment banker,1,resources,282607,282872,265,q,1
115251,18,3,3,7,10,f,Monica.jpg,pieFS3.bmp,Monica used her mother's social security number to open a credit card account.,1,reputation,295143,296951,1808,p,0
115251,19,4,1,4,5,m,Don.jpg,pieFS4.bmp,Don stole money from his mother's wallet.,1,reputation,309211,316832,7621,p,0
115251,20,4,1,4,5,f,Lauren.jpg,pieFS4.bmp,Lauren is raising money to buy gifts for children in need.,2,na,329088,329752,664,q,1
115251,21,5,2,18,20,m,Daniel.jpg,pieFS5.bmp,Daniel just lost his job,2,na,342007,350752,8745,p,0
115251,22,2,3,4,7,f,Jean.jpg,pieFS2.bmp,Jean illegally parks in the disabled parking spots when she can.,1,reputation,363050,364952,1902,q,1
115251,23,4,2,8,10,f,Beth.jpg,pieFS4.bmp,Beth can't afford to pay her medical bills,2,na,377201,377272,71,p,0
115251,24,4,3,12,15,m,Tony.jpg,pieFS4.bmp,Tony lost his life savings when his small business failed,2,na,389504,391672,2168,q,1
115251,25,3,3,7,10,m,Sam.jpg,pieFS3.bmp,Sam cheated on his taxes and is now under investigation for tax fraud.,1,reputation,403904,405672,1768,p,0
115251,26,4,3,12,15,f,Arianna.jpg,pieFS4.bmp,Arianna is going to be evicted because she is behind on her rent,2,na,417905,422452,4547,q,1
115251,27,5,1,9,10,f,Fiona.jpg,pieFS5.bmp,Fiona owns an international company,1,resources,434703,437612,2909,q,1
115251,28,4,4,16,20,m,Matt.jpg,pieFS4.bmp,Matt is a veteran having trouble finding employment.,2,na,449869,453992,4123,q,1
115251,29,3,2,4,6,f,Kelly.jpg,pieFS3.bmp,Kelly's car with her bag and credit cards was recently stolen.,2,na,466267,468352,2085,p,0
115251,30,3,5,11,16,f,Emma.jpg,pieFS3.bmp,Emma received a large inheritance from a distant relative,1,resources,480601,481312,711,q,1
115251,31,2,6,9,15,m,Darnell.jpg,pieFS2.bmp,Darnell stole his elderly father's prescription medications.,1,reputation,493603,495092,1489,p,0
115251,32,1,8,8,16,m,Saul.jpg,pieFS1.bmp,Saul declared bankruptcy after he was laid off.,2,na,507371,509392,2021,q,1
115251,33,4,2,8,10,f,Maria.jpg,pieFS4.bmp,Maria just found out that her husband has incurred a large credit card debt.,2,na,521672,523892,2220,q,1
115251,34,4,3,12,15,m,Michael.jpg,pieFS4.bmp,Michael takes valuables from his friends' homes when asked to house-sit.,1,reputation,536172,537472,1300,p,0
115251,35,5,1,9,10,m,Ian.jpg,pieFS5.bmp,Ian was injured in a hit-and-run accident and cannot afford his medical bills.,2,na,549740,550272,532,q,1
115251,36,4,1,4,5,m,Mark.jpg,pieFS4.bmp,Mark was mugged and had his wallet stolen.,2,na,562543,567232,4689,q,1
115251,37,5,2,18,20,m,Paul.jpg,pieFS5.bmp,Paul employs illegal immigrants and pays them less than minimum wage.,1,reputation,579507,582752,3245,q,1
115251,38,2,8,12,20,f,Cindy.jpg,pieFS2.bmp,Cindy is a highly paid actress,1,resources,595006,598072,3066,q,1
115251,39,5,1,9,10,f,Jenny.jpg,pieFS5.bmp,Jenny has to take an unpaid leave of absence because her mother broke her hip.,2,na,610355,612112,1757,q,1
115251,40,1,9,9,18,m,Ben.jpg,pieFS1.bmp,Ben often goes through and steals the neighbors' mail.,1,reputation,624373,625192,819,p,0
115251,41,3,5,11,16,m,Edward.jpg,pieFS3.bmp,Edward could not afford his mortgage and his home was foreclosed.,2,na,637442,638552,1110,q,1
115251,42,3,6,14,20,m,Jack.jpg,pieFS3.bmp,Jack has been unable to find a job for over a year.,2,na,650793,651092,299,q,1
115251,43,3,4,9,13,m,Ricky.jpg,pieFS3.bmp,Ricky is hiding his taxable income in Switzerland.,1,reputation,663346,668093,4747,p,0
115251,44,5,2,18,20,f,Jackie.jpg,pieFS5.bmp,Jackie got a large cash bonus from her boss,1,resources,680343,681353,1010,p,0
115251,45,3,2,4,6,f,Sharon.jpg,pieFS3.bmp,Sharon is a single mother,2,na,693612,699913,6301,q,1
115251,46,5,1,9,10,m,Kevin.jpg,pieFS5.bmp,Kevin lost his house in a fire,2,na,712191,712893,702,q,1
115251,47,5,2,18,20,m,Stuart.jpg,pieFS5.bmp,Stuart just found $50 on the street,1,resources,725143,727753,2610,q,1
115251,48,4,4,16,20,f,Louise.jpg,pieFS4.bmp,Louise just won the lottery,1,resources,740026,743353,3327,p,0
115251,49,5,1,9,10,f,Kay.jpg,pieFS5.bmp,Kay cannot afford to send her son to college.,2,na,755625,757133,1508,q,1
115251,50,4,2,8,10,m,Joe.jpg,pieFS4.bmp,Joe underreports his company's earnings and pockets the profits.,1,reputation,769410,770973,1563,p,0
115251,51,2,7,10,17,f,Sammy.jpg,pieFS2.bmp,Sammy was a victim of identity theft and is now thousands of dollars in debt.,2,na,783244,784573,1329,q,1
115251,52,5,1,9,10,f,Mary.jpg,pieFS5.bmp,Mary regularly fires employees to avoid promoting them.,1,reputation,796846,798333,1487,p,0
115300,1,2,6,9,15,m,Mark.jpg,pieFS2.bmp,Mark is saving to pay his university fees,2,na,124637,142879,18242,q,1
115300,2,4,4,16,20,f,Monica.jpg,pieFS4.bmp,Monica illegally parks in the disabled parking spots when she can.,1,reputation,155069,161939,6870,q,1
115300,3,3,2,4,6,f,Joanna.jpg,pieFS3.bmp,Joanna's car with her bag and credit cards was recently stolen.,2,na,174131,177779,3648,p,0
115300,4,2,6,9,15,m,Brad.jpg,pieFS2.bmp,Brad lives in a luxury penthouse apartment,1,resources,189980,192839,2859,q,1
115300,5,4,2,8,10,m,Saul.jpg,pieFS4.bmp,Saul stole money from his mother's wallet.,1,reputation,205030,208779,3749,p,0
115300,6,4,2,8,10,m,Edward.jpg,pieFS4.bmp,Edward underreports his company's earnings and pockets the profits.,1,reputation,220978,223419,2441,p,0
115300,7,5,1,9,10,f,Jenny.jpg,pieFS5.bmp,Jenny just found out that her husband has incurred a large credit card debt.,2,na,235612,237439,1827,q,1
115300,8,5,2,18,20,f,Arianna.jpg,pieFS5.bmp,Arianna claims false expenses for her reportable work travel.,1,reputation,249629,252539,2910,q,1
115300,9,4,3,12,15,f,Kelly.jpg,pieFS4.bmp,Kelly is a highly paid actress,1,resources,264729,272879,8150,q,1
115300,10,3,5,11,16,m,Darnell.jpg,pieFS3.bmp,Darnell lost his life savings when his small business failed,2,na,285073,287159,2086,p,0
115300,11,4,3,12,15,m,Matt.jpg,pieFS4.bmp,Matt cheated on his taxes and is now under investigation for tax fraud.,1,reputation,299340,303079,3739,p,0
115300,12,4,1,4,5,f,Jean.jpg,pieFS4.bmp,Jean has to take an unpaid leave of absence because her mother broke her hip.,2,na,315256,317939,2683,q,1
115300,13,2,3,4,7,m,Nick.jpg,pieFS2.bmp,Nick is a veteran having trouble finding employment.,2,na,330139,333339,3200,p,0
115300,14,5,2,18,20,m,Peter.jpg,pieFS5.bmp,Peter stole his elderly father's prescription medications.,1,reputation,345505,350440,4935,p,0
115300,15,4,4,16,20,f,Lauren.jpg,pieFS4.bmp,Lauren got a large cash bonus from her boss,1,resources,362602,367520,4918,q,1
115300,16,5,1,9,10,f,Eileen.jpg,pieFS5.bmp,Eileen was a victim of identity theft and is now thousands of dollars in debt.,2,na,379683,381840,2157,q,1
115300,17,3,3,7,10,f,Miriam.jpg,pieFS3.bmp,Miriam works as a cleaner in a hotel,2,na,394000,400000,6000,p,0
115300,18,1,5,5,10,f,Kay.jpg,pieFS1.bmp,Kay's husband is a wealthy investment banker,1,resources,412163,415860,3697,q,1
115300,19,4,3,12,15,m,Michael.jpg,pieFS4.bmp,Michael declared bankruptcy after he was laid off.,2,na,428012,432620,4608,q,1
115300,20,1,10,10,20,f,Beth.jpg,pieFS1.bmp,Beth can't afford to pay her medical bills,2,na,444777,447720,2943,q,1
115300,21,5,1,9,10,m,Joe.jpg,pieFS5.bmp,Joe is a well paid lawyer,1,resources,459876,467200,7324,p,0
115300,22,3,2,4,6,f,Janet.jpg,pieFS3.bmp,Janet is going to be evicted because she is behind on her rent,2,na,479355,481500,2145,q,1
115300,23,3,4,9,13,m,Tony.jpg,pieFS3.bmp,Tony takes valuables from his friends' homes when asked to house-sit.,1,reputation,493672,495560,1888,q,1
115300,24,4,3,12,15,f,Jackie.jpg,pieFS4.bmp,Jackie works two waitressing jobs to pay her bills.,2,na,507723,511840,4117,q,1
115300,25,3,3,7,10,f,Fiona.jpg,pieFS3.bmp,Fiona owns an international company,1,resources,523988,526840,2852,q,1
115300,26,5,1,9,10,f,Emma.jpg,pieFS5.bmp,Emma received a large inheritance from a distant relative,1,resources,538987,541360,2373,p,0
115300,27,2,3,4,7,f,Maria.jpg,pieFS2.bmp,Maria just received a huge cash settlement,1,resources,553521,556080,2559,q,1
115300,28,5,2,18,20,m,Jack.jpg,pieFS5.bmp,Jack was injured in a hit-and-run accident and cannot afford his medical bills.,2,na,568255,571120,2865,p,0
115300,29,3,2,4,6,f,Marny.jpg,pieFS3.bmp,Marny takes discarded food from grocery stores to feed her children.,2,na,583288,585380,2092,q,1
115300,30,4,4,16,20,m,Kevin.jpg,pieFS4.bmp,Kevin was mugged and had his wallet stolen.,2,na,597572,601041,3469,q,1
115300,31,1,9,9,18,m,Ben.jpg,pieFS1.bmp,Ben often goes through and steals the neighbors' mail.,1,reputation,613221,615840,2619,q,1
115300,32,5,2,18,20,m,Ian.jpg,pieFS5.bmp,Ian has been unable to find a job for over a year.,2,na,627987,632340,4353,p,0
115300,33,3,2,4,6,f,Cindy.jpg,pieFS3.bmp,Cindy steals her coworkers' tips to buy alcohol.,1,reputation,644502,646440,1938,q,1
115300,34,4,1,4,5,m,Justin.jpg,pieFS4.bmp,Justin is a retiree,2,na,658603,664421,5818,q,1
115300,35,3,4,9,13,m,Jared.jpg,pieFS3.bmp,Jared just bought an expensive sports car,1,resources,676599,681861,5262,q,1
115300,36,4,2,8,10,f,Sammy.jpg,pieFS4.bmp,Sammy just lost her small business after a franchise moved in next door.,2,na,694046,696440,2394,p,0
115300,37,2,8,12,20,f,Emily.jpg,pieFS2.bmp,Emily used her mother's social security number to open a credit card account.,1,reputation,708630,711141,2511,q,1
115300,38,4,2,8,10,f,Fay.jpg,pieFS4.bmp,Fay is a single mother,2,na,723330,729361,6031,p,0
115300,39,5,1,9,10,f,Mary.jpg,pieFS5.bmp,Mary just won the lottery,1,resources,741560,747261,5701,p,0
115300,40,3,6,14,20,m,Alan.jpg,pieFS3.bmp,Alan is saving for his son's operation,2,na,759456,761321,1865,q,1
115300,41,3,3,7,10,m,George.jpg,pieFS3.bmp,George bullies his employees to put in extra hours at work.,1,reputation,773507,775661,2154,p,0
115300,42,3,6,14,20,m,Ricky.jpg,pieFS3.bmp,Ricky just lost his job,2,na,787858,790021,2163,q,1
115300,43,3,4,9,13,m,Paul.jpg,pieFS3.bmp,Paul employs illegal immigrants and pays them less than minimum wage.,1,reputation,802208,804301,2093,p,0
115300,44,1,8,8,16,m,Stuart.jpg,pieFS1.bmp,Stuart lost his house in a fire,2,na,816492,817921,1429,q,1
115300,45,5,1,9,10,m,Daniel.jpg,pieFS5.bmp,Daniel could not afford his mortgage and his home was foreclosed.,2,na,830110,832501,2391,p,0
115300,46,5,2,18,20,m,Don.jpg,pieFS5.bmp,Don just found $50 on the street,1,resources,844694,848841,4147,p,0
115300,47,2,7,10,17,f,Louise.jpg,pieFS2.bmp,Louise cannot afford to send her son to college.,2,na,861042,862561,1519,q,1
115300,48,5,1,9,10,f,Deborah.jpg,pieFS5.bmp,Deborah is raising money to buy gifts for children in need.,2,na,874760,878101,3341,q,1
115300,49,4,1,4,5,m,Taymar.jpg,pieFS4.bmp,Taymar is hiding his taxable income in Switzerland.,1,reputation,890292,891641,1349,p,0
115300,50,5,1,9,10,f,Sharon.jpg,pieFS5.bmp,Sharon regularly fires employees to avoid promoting them.,1,reputation,903844,906101,2257,p,0
115300,51,3,5,11,16,f,Trish.jpg,pieFS3.bmp,Trish secretly gambles with her husband's savings.,1,reputation,918294,920541,2247,q,1
115300,52,5,1,9,10,m,Sam.jpg,pieFS5.bmp,Sam is homeless,2,na,932745,935521,2776,p,0
202200,1,1,10,10,20,f,Trish.jpg,pieFS1.bmp,Trish is going to be evicted because she is behind on her rent,2,na,49402,53951,4549,q,1
202200,2,3,3,7,10,f,Beth.jpg,pieFS3.bmp,Beth owns an international company,1,resources,66123,69288,3165,q,1
202200,3,5,1,9,10,m,Peter.jpg,pieFS5.bmp,Peter cheated on his taxes and is now under investigation for tax fraud.,1,reputation,81490,83988,2498,p,0
202200,4,2,3,4,7,f,Sharon.jpg,pieFS2.bmp,Sharon received a large inheritance from a distant relative,1,resources,96187,98462,2275,q,1
202200,5,4,3,12,15,m,Darnell.jpg,pieFS4.bmp,Darnell is a veteran having trouble finding employment.,2,na,110651,114418,3767,p,0
202200,6,4,2,8,10,m,Tony.jpg,pieFS4.bmp,Tony stole his elderly father's prescription medications.,1,reputation,126619,129155,2536,p,0
202200,7,5,2,18,20,m,George.jpg,pieFS5.bmp,George underreports his company's earnings and pockets the profits.,1,reputation,141350,143649,2299,p,0
202200,8,5,1,9,10,f,Miriam.jpg,pieFS5.bmp,Miriam is a single mother,2,na,155847,158104,2257,p,0
202200,9,5,1,9,10,f,Janet.jpg,pieFS5.bmp,Janet just won the lottery,1,resources,170311,172334,2023,p,0
202200,10,3,3,7,10,f,Monica.jpg,pieFS3.bmp,Monica has to take an unpaid leave of absence because her mother broke her hip.,2,na,184524,186509,1985,q,1
202200,11,3,6,14,20,m,Ian.jpg,pieFS3.bmp,Ian declared bankruptcy after he was laid off.,2,na,198686,201602,2916,p,0
202200,12,2,6,9,15,m,Edward.jpg,pieFS2.bmp,Edward is a well paid lawyer,1,resources,213802,215888,2086,q,1
202200,13,3,4,9,13,m,Sam.jpg,pieFS3.bmp,Sam takes valuables from his friends' homes when asked to house-sit.,1,reputation,228065,230269,2204,p,0
202200,14,4,3,12,15,f,Eileen.jpg,pieFS4.bmp,Eileen got a large cash bonus from her boss,1,resources,242445,244688,2243,p,0
202200,15,4,2,8,10,f,Lauren.jpg,pieFS4.bmp,Lauren was a victim of identity theft and is now thousands of dollars in debt.,2,na,256842,259195,2353,p,0
202200,16,4,2,8,10,f,Jean.jpg,pieFS4.bmp,Jean works two waitressing jobs to pay her bills.,2,na,271389,273768,2379,q,1
202200,17,2,8,12,20,f,Sammy.jpg,pieFS2.bmp,Sammy just received a huge cash settlement,1,resources,285953,287849,1896,q,1
202200,18,1,8,8,16,m,Don.jpg,pieFS1.bmp,Don was injured in a hit-and-run accident and cannot afford his medical bills.,2,na,300048,302980,2932,q,1
202200,19,4,4,16,20,m,Daniel.jpg,pieFS4.bmp,Daniel is a retiree,2,na,315181,317056,1875,p,0
202200,20,2,6,9,15,m,Brad.jpg,pieFS2.bmp,Brad was mugged and had his wallet stolen.,2,na,329243,331366,2123,q,1
202200,21,4,3,12,15,f,Marny.jpg,pieFS4.bmp,Marny takes discarded food from grocery stores to feed her children.,2,na,343556,346009,2453,q,1
202200,22,3,3,7,10,m,Taymar.jpg,pieFS3.bmp,Taymar just bought an expensive sports car,1,resources,358204,359770,1566,p,0
202200,23,1,9,9,18,m,Matt.jpg,pieFS1.bmp,Matt often goes through and steals the neighbors' mail.,1,reputation,371965,373903,1938,p,0
202200,24,2,7,10,17,f,Fiona.jpg,pieFS2.bmp,Fiona cannot afford to send her son to college.,2,na,386094,388008,1914,q,1
202200,25,4,4,16,20,f,Cindy.jpg,pieFS4.bmp,Cindy steals her coworkers' tips to buy alcohol.,1,reputation,400206,402166,1960,p,0
202200,26,5,2,18,20,m,Jared.jpg,pieFS5.bmp,Jared is saving for his son's operation,2,na,414369,415906,1537,p,0
202200,27,3,4,9,13,m,Ricky.jpg,pieFS3.bmp,Ricky bullies his employees to put in extra hours at work.,1,reputation,428080,430863,2783,p,0
202200,28,4,1,4,5,m,Kevin.jpg,pieFS4.bmp,Kevin has been unable to find a job for over a year.,2,na,443079,445437,2358,q,1
202200,29,5,1,9,10,f,Kay.jpg,pieFS5.bmp,Kay regularly fires employees to avoid promoting them.,1,reputation,457609,459668,2059,p,0
202200,30,4,1,4,5,f,Kelly.jpg,pieFS4.bmp,Kelly just lost her small business after a franchise moved in next door.,2,na,471872,474086,2214,p,0
202200,31,3,5,11,16,m,Saul.jpg,pieFS3.bmp,Saul lost his house in a fire,2,na,486285,488223,1938,q,1
202200,32,4,4,16,20,f,Maria.jpg,pieFS4.bmp,Maria used her mother's social security number to open a credit card account.,1,reputation,500415,502135,1720,p,0
202200,33,5,1,9,10,f,Arianna.jpg,pieFS5.bmp,Arianna secretly gambles with her husband's savings.,1,reputation,514326,516028,1702,p,0
202200,34,5,2,18,20,m,Joe.jpg,pieFS5.bmp,Joe just lost his job,2,na,528188,530370,2182,q,1
202200,35,5,1,9,10,f,Emily.jpg,pieFS5.bmp,Emily is raising money to buy gifts for children in need.,2,na,542568,544508,1940,p,0
202200,36,4,2,8,10,m,Paul.jpg,pieFS4.bmp,Paul employs illegal immigrants and pays them less than minimum wage.,1,reputation,556697,558003,1306,p,0
202200,37,5,2,18,20,f,Jenny.jpg,pieFS5.bmp,Jenny illegally parks in the disabled parking spots when she can.,1,reputation,570191,572013,1822,p,0
202200,38,4,3,12,15,m,Ben.jpg,pieFS4.bmp,Ben just found $50 on the street,1,resources,584203,586075,1872,p,0
202200,39,3,2,4,6,f,Deborah.jpg,pieFS3.bmp,Deborah's car with her bag and credit cards was recently stolen.,2,na,598248,600156,1908,q,1
202200,40,5,1,9,10,m,Alan.jpg,pieFS5.bmp,Alan could not afford his mortgage and his home was foreclosed.,2,na,612344,614326,1982,q,1
202200,41,5,1,9,10,m,Jack.jpg,pieFS5.bmp,Jack is homeless,2,na,626523,628111,1588,p,0
202200,42,3,6,14,20,m,Michael.jpg,pieFS3.bmp,Michael is saving to pay his university fees,2,na,640301,642023,1722,q,1
202200,43,1,5,5,10,f,Emma.jpg,pieFS1.bmp,Emma claims false expenses for her reportable work travel.,1,reputation,654213,656047,1834,p,0
202200,44,3,2,4,6,f,Joanna.jpg,pieFS3.bmp,Joanna just found out that her husband has incurred a large credit card debt.,2,na,668242,670185,1943,q,1
202200,45,5,1,9,10,f,Louise.jpg,pieFS5.bmp,Louise works as a cleaner in a hotel,2,na,682354,684134,1780,p,0
202200,46,3,5,11,16,f,Jackie.jpg,pieFS3.bmp,Jackie is a highly paid actress,1,resources,696316,698214,1898,q,1
202200,47,3,2,4,6,f,Mary.jpg,pieFS3.bmp,Mary's husband is a wealthy investment banker,1,resources,710429,712316,1887,p,0
202200,48,4,1,4,5,m,Stuart.jpg,pieFS4.bmp,Stuart lives in a luxury penthouse apartment,1,resources,724508,725926,1418,p,0
202200,49,3,4,9,13,m,Mark.jpg,pieFS3.bmp,Mark stole money from his mother's wallet.,1,reputation,738119,739533,1414,p,0
202200,50,5,2,18,20,m,Justin.jpg,pieFS5.bmp,Justin is hiding his taxable income in Switzerland.,1,reputation,751729,753300,1571,p,0
202200,51,2,3,4,7,m,Nick.jpg,pieFS2.bmp,Nick lost his life savings when his small business failed,2,na,765507,767456,1949,q,1
202200,52,3,2,4,6,f,Fay.jpg,pieFS3.bmp,Fay can't afford to pay her medical bills,2,na,779637,781761,2124,q,1
203803,1,5,1,9,10,m,Mark.jpg,pieFS5.bmp,Mark declared bankruptcy after he was laid off.,2,na,39396,48761,9365,q,1
203803,2,5,2,18,20,m,Ian.jpg,pieFS5.bmp,Ian takes valuables from his friends' homes when asked to house-sit.,1,reputation,61072,64105,3033,p,0
203803,3,4,2,8,10,m,George.jpg,pieFS4.bmp,George just bought an expensive sports car,1,resources,76421,81042,4621,p,0
203803,4,3,6,14,20,m,Joe.jpg,pieFS3.bmp,Joe is saving for his son's operation,2,na,93369,97562,4193,q,1
203803,5,3,5,11,16,m,Tony.jpg,pieFS3.bmp,Tony was injured in a hit-and-run accident and cannot afford his medical bills.,2,na,109884,112603,2719,q,1
203803,6,5,1,9,10,f,Beth.jpg,pieFS5.bmp,Beth secretly gambles with her husband's savings.,1,reputation,124918,127343,2425,p,0
203803,7,2,3,4,7,m,Don.jpg,pieFS2.bmp,Don was mugged and had his wallet stolen.,2,na,139684,141923,2239,q,1
203803,8,1,10,10,20,f,Joanna.jpg,pieFS1.bmp,Joanna just lost her small business after a franchise moved in next door.,2,na,154252,160804,6552,q,1
203803,9,3,3,7,10,f,Emily.jpg,pieFS3.bmp,Emily used her mother's social security number to open a credit card account.,1,reputation,173147,176344,3197,p,0
203803,10,4,3,12,15,f,Louise.jpg,pieFS4.bmp,Louise claims false expenses for her reportable work travel.,1,reputation,188647,190664,2017,p,0
203803,11,4,2,8,10,m,Justin.jpg,pieFS4.bmp,Justin bullies his employees to put in extra hours at work.,1,reputation,202964,203824,860,p,0
203803,12,4,2,8,10,f,Cindy.jpg,pieFS4.bmp,Cindy is raising money to buy gifts for children in need.,2,na,216133,218045,1912,q,1
203803,13,4,3,12,15,m,Paul.jpg,pieFS4.bmp,Paul just lost his job,2,na,230367,232965,2598,q,1
203803,14,1,5,5,10,f,Monica.jpg,pieFS1.bmp,Monica illegally parks in the disabled parking spots when she can.,1,reputation,245301,247365,2064,p,0
203803,15,4,2,8,10,f,Sharon.jpg,pieFS4.bmp,Sharon works as a cleaner in a hotel,2,na,259668,264786,5118,q,1
203803,16,3,4,9,13,m,Jared.jpg,pieFS3.bmp,Jared employs illegal immigrants and pays them less than minimum wage.,1,reputation,277065,278766,1701,p,0
203803,17,5,1,9,10,f,Miriam.jpg,pieFS5.bmp,Miriam's husband is a wealthy investment banker,1,resources,291083,293526,2443,p,0
203803,18,5,1,9,10,m,Sam.jpg,pieFS5.bmp,Sam often goes through and steals the neighbors' mail.,1,reputation,305867,307927,2060,p,0
203803,19,5,2,18,20,m,Kevin.jpg,pieFS5.bmp,Kevin has been unable to find a job for over a year.,2,na,320234,323027,2793,q,1
203803,20,3,2,4,6,f,Janet.jpg,pieFS3.bmp,Janet can't afford to pay her medical bills,2,na,335284,338687,3403,q,1
203803,21,3,3,7,10,f,Kay.jpg,pieFS3.bmp,Kay is going to be evicted because she is behind on her rent,2,na,350983,355327,4344,q,1
203803,22,2,6,9,15,m,Stuart.jpg,pieFS2.bmp,Stuart lost his house in a fire,2,na,367631,371288,3657,q,1
203803,23,2,7,10,17,f,Lauren.jpg,pieFS2.bmp,Lauren's car with her bag and credit cards was recently stolen.,2,na,383564,386828,3264,q,1
203803,24,5,2,18,20,f,Mary.jpg,pieFS5.bmp,Mary owns an international company,1,resources,399097,401388,2291,p,0
203803,25,1,8,8,16,m,Alan.jpg,pieFS1.bmp,Alan could not afford his mortgage and his home was foreclosed.,2,na,413664,419769,6105,q,1
203803,26,3,5,11,16,f,Fay.jpg,pieFS3.bmp,Fay received a large inheritance from a distant relative,1,resources,432010,434249,2239,p,0
203803,27,5,1,9,10,f,Jenny.jpg,pieFS5.bmp,Jenny just found out that her husband has incurred a large credit card debt.,2,na,446477,450469,3992,q,1
203803,28,2,6,9,15,m,Edward.jpg,pieFS2.bmp,Edward is hiding his taxable income in Switzerland.,1,reputation,462693,466209,3516,p,0
203803,29,3,4,9,13,m,Michael.jpg,pieFS3.bmp,Michael just found $50 on the street,1,resources,478425,481830,3405,q,1
203803,30,5,2,18,20,m,Saul.jpg,pieFS5.bmp,Saul is homeless,2,na,494041,497070,3029,q,1
203803,31,3,2,4,6,f,Fiona.jpg,pieFS3.bmp,Fiona is a single mother,2,na,509291,512731,3440,q,1
203803,32,2,8,12,20,f,Trish.jpg,pieFS2.bmp,Trish just won the lottery,1,resources,524957,527931,2974,q,1
203803,33,4,4,16,20,f,Eileen.jpg,pieFS4.bmp,Eileen is a highly paid actress,1,resources,540157,545291,5134,q,1
203803,34,3,6,14,20,m,Darnell.jpg,pieFS3.bmp,Darnell is saving to pay his university fees,2,na,557521,561031,3510,q,1
203803,35,3,2,4,6,f,Jean.jpg,pieFS3.bmp,Jean has to take an unpaid leave of absence because her mother broke her hip.,2,na,573253,575332,2079,q,1
203803,36,5,1,9,10,f,Sammy.jpg,pieFS5.bmp,Sammy got a large cash bonus from her boss,1,resources,587554,592172,4618,q,1
203803,37,1,9,9,18,m,Ricky.jpg,pieFS1.bmp,Ricky underreports his company's earnings and pockets the profits.,1,reputation,604402,607232,2830,p,0
203803,38,4,1,4,5,f,Jackie.jpg,pieFS4.bmp,Jackie was a victim of identity theft and is now thousands of dollars in debt.,2,na,619485,621593,2108,q,1
203803,39,5,1,9,10,f,Marny.jpg,pieFS5.bmp,Marny works two waitressing jobs to pay her bills.,2,na,633853,635633,1780,q,1
203803,40,2,3,4,7,f,Kelly.jpg,pieFS2.bmp,Kelly just received a huge cash settlement,1,resources,647904,652713,4809,q,1
203803,41,4,3,12,15,m,Peter.jpg,pieFS4.bmp,Peter lives in a luxury penthouse apartment,1,resources,664968,667893,2925,p,0
203803,42,4,1,4,5,m,Jack.jpg,pieFS4.bmp,Jack stole money from his mother's wallet.,1,reputation,680168,683234,3066,p,0
203803,43,5,1,9,10,f,Arianna.jpg,pieFS5.bmp,Arianna cannot afford to send her son to college.,2,na,695468,698034,2566,q,1
203803,44,4,4,16,20,m,Brad.jpg,pieFS4.bmp,Brad lost his life savings when his small business failed,2,na,710235,713314,3079,q,1
203803,45,3,4,9,13,m,Matt.jpg,pieFS3.bmp,Matt cheated on his taxes and is now under investigation for tax fraud.,1,reputation,725534,731215,5681,p,0
203803,46,5,2,18,20,m,Daniel.jpg,pieFS5.bmp,Daniel is a well paid lawyer,1,resources,743448,745435,1987,p,0
203803,47,4,3,12,15,f,Maria.jpg,pieFS4.bmp,Maria takes discarded food from grocery stores to feed her children.,2,na,757665,759695,2030,q,1
203803,48,4,4,16,20,f,Emma.jpg,pieFS4.bmp,Emma regularly fires employees to avoid promoting them.,1,reputation,771916,773435,1519,p,0
203803,49,4,1,4,5,m,Nick.jpg,pieFS4.bmp,Nick is a veteran having trouble finding employment.,2,na,785667,787936,2269,q,1
203803,50,3,2,4,6,f,Deborah.jpg,pieFS3.bmp,Deborah steals her coworkers' tips to buy alcohol.,1,reputation,800168,804796,4628,p,0
203803,51,3,3,7,10,m,Ben.jpg,pieFS3.bmp,Ben stole his elderly father's prescription medications.,1,reputation,817016,817996,980,p,0
203803,52,5,1,9,10,m,Taymar.jpg,pieFS5.bmp,Taymar is a retiree,2,na,830251,835517,5266,q,1
204059,1,5,1,9,10,m,Tony.jpg,pieFS5.bmp,Tony declared bankruptcy after he was laid off.,2,na,38710,42952,4242,m,0
204059,2,4,2,8,10,f,Louise.jpg,pieFS4.bmp,Louise can't afford to pay her medical bills,2,na,55063,57986,2923,m,0
204059,3,5,2,18,20,m,Ricky.jpg,pieFS5.bmp,Ricky is hiding his taxable income in Switzerland.,1,reputation,70079,72440,2361,m,0
204059,4,1,10,10,20,f,Trish.jpg,pieFS1.bmp,Trish is going to be evicted because she is behind on her rent,2,na,84542,87331,2789,z,1
204059,5,2,6,9,15,m,Edward.jpg,pieFS2.bmp,Edward underreports his company's earnings and pockets the profits.,1,reputation,99441,104431,4990,z,1
204059,6,4,1,4,5,f,Emily.jpg,pieFS4.bmp,Emily's car with her bag and credit cards was recently stolen.,2,na,116529,119086,2557,m,0
204059,7,2,7,10,17,f,Jackie.jpg,pieFS2.bmp,Jackie just found out that her husband has incurred a large credit card debt.,2,na,131194,133602,2408,z,1
204059,8,1,9,9,18,m,Don.jpg,pieFS1.bmp,Don takes valuables from his friends' homes when asked to house-sit.,1,reputation,145691,148044,2353,z,1
204059,9,2,3,4,7,m,Jack.jpg,pieFS2.bmp,Jack was injured in a hit-and-run accident and cannot afford his medical bills.,2,na,160137,162647,2510,z,1
204059,10,4,2,8,10,m,Joe.jpg,pieFS4.bmp,Joe is a well paid lawyer,1,resources,174718,177326,2608,m,0
204059,11,1,5,5,10,f,Kay.jpg,pieFS1.bmp,Kay owns an international company,1,resources,189399,191780,2381,z,1
204059,12,3,3,7,10,f,Kelly.jpg,pieFS3.bmp,Kelly is a highly paid actress,1,resources,203896,206203,2307,m,0
204059,13,3,2,4,6,f,Maria.jpg,pieFS3.bmp,Maria has to take an unpaid leave of absence because her mother broke her hip.,2,na,218293,220658,2365,z,1
204059,14,5,1,9,10,f,Monica.jpg,pieFS5.bmp,Monica got a large cash bonus from her boss,1,resources,232756,235330,2574,m,0
204059,15,3,2,4,6,f,Sharon.jpg,pieFS3.bmp,Sharon received a large inheritance from a distant relative,1,resources,247421,249862,2441,z,1
204059,16,5,2,18,20,m,Ian.jpg,pieFS5.bmp,Ian was mugged and had his wallet stolen.,2,na,261951,264175,2224,m,0
204059,17,5,1,9,10,f,Sammy.jpg,pieFS5.bmp,Sammy was a victim of identity theft and is now thousands of dollars in debt.,2,na,276264,278311,2047,m,0
204059,18,4,3,12,15,f,Deborah.jpg,pieFS4.bmp,Deborah works two waitressing jobs to pay her bills.,2,na,290427,292832,2405,m,0
204059,19,3,4,9,13,m,Mark.jpg,pieFS3.bmp,Mark often goes through and steals the neighbors' mail.,1,reputation,304924,307630,2706,z,1
204059,20,4,1,4,5,m,Peter.jpg,pieFS4.bmp,Peter has been unable to find a job for over a year.,2,na,319722,321943,2221,m,0
204059,21,4,3,12,15,m,Jared.jpg,pieFS4.bmp,Jared is a retiree,2,na,334018,336416,2398,m,0
204059,22,4,4,16,20,m,Darnell.jpg,pieFS4.bmp,Darnell lost his house in a fire,2,na,348498,350976,2478,m,0
204059,23,3,2,4,6,f,Fiona.jpg,pieFS3.bmp,Fiona is a single mother,2,na,363045,365227,2182,z,1
204059,24,3,3,7,10,m,Paul.jpg,pieFS3.bmp,Paul just bought an expensive sports car,1,resources,377308,381259,3951,z,1
204059,25,3,6,14,20,m,Alan.jpg,pieFS3.bmp,Alan is saving for his son's operation,2,na,393344,395363,2019,z,1
204059,26,5,1,9,10,m,Taymar.jpg,pieFS5.bmp,Taymar bullies his employees to put in extra hours at work.,1,reputation,407456,409792,2336,m,0
204059,27,4,3,12,15,m,Michael.jpg,pieFS4.bmp,Michael just found $50 on the street,1,resources,421886,428168,6282,z,1
204059,28,3,6,14,20,m,Nick.jpg,pieFS3.bmp,Nick is homeless,2,na,440263,442434,2171,z,1
204059,29,5,1,9,10,f,Beth.jpg,pieFS5.bmp,Beth just won the lottery,1,resources,454525,457819,3294,m,0
204059,30,2,6,9,15,m,Kevin.jpg,pieFS2.bmp,Kevin is saving to pay his university fees,2,na,469909,472059,2150,z,1
204059,31,3,5,11,16,m,Justin.jpg,pieFS3.bmp,Justin just lost his job,2,na,484155,486466,2311,z,1
204059,32,4,4,16,20,f,Jean.jpg,pieFS4.bmp,Jean just received a huge cash settlement,1,resources,498552,501326,2774,m,0
204059,33,5,1,9,10,f,Marny.jpg,pieFS5.bmp,Marny takes discarded food from grocery stores to feed her children.,2,na,513416,515490,2074,m,0
204059,34,5,2,18,20,f,Eileen.jpg,pieFS5.bmp,Eileen steals her coworkers' tips to buy alcohol.,1,reputation,527562,529468,1906,m,0
204059,35,3,3,7,10,f,Miriam.jpg,pieFS3.bmp,Miriam cannot afford to send her son to college.,2,na,541558,543875,2317,z,1
204059,36,4,3,12,15,f,Arianna.jpg,pieFS4.bmp,Arianna regularly fires employees to avoid promoting them.,1,reputation,555971,558216,2245,m,0
204059,37,4,2,8,10,f,Cindy.jpg,pieFS4.bmp,Cindy just lost her small business after a franchise moved in next door.,2,na,570301,572560,2259,m,0
204059,38,4,4,16,20,f,Lauren.jpg,pieFS4.bmp,Lauren used her mother's social security number to open a credit card account.,1,reputation,584647,588970,4323,m,0
204059,39,3,2,4,6,f,Joanna.jpg,pieFS3.bmp,Joanna is raising money to buy gifts for children in need.,2,na,601067,603518,2451,z,1
204059,40,3,4,9,13,m,Daniel.jpg,pieFS3.bmp,Daniel employs illegal immigrants and pays them less than minimum wage.,1,reputation,615615,617534,1919,z,1
204059,41,4,1,4,5,m,Stuart.jpg,pieFS4.bmp,Stuart lives in a luxury penthouse apartment,1,resources,629627,632613,2986,m,0
204059,42,3,4,9,13,m,Matt.jpg,pieFS3.bmp,Matt stole money from his mother's wallet.,1,reputation,644709,648234,3525,z,1
204059,43,2,8,12,20,f,Mary.jpg,pieFS2.bmp,Mary secretly gambles with her husband's savings.,1,reputation,660309,662391,2082,z,1
204059,44,5,1,9,10,f,Emma.jpg,pieFS5.bmp,Emma claims false expenses for her reportable work travel.,1,reputation,674489,676517,2028,m,0
204059,45,5,1,9,10,m,George.jpg,pieFS5.bmp,George could not afford his mortgage and his home was foreclosed.,2,na,688601,691408,2807,m,0
204059,46,2,3,4,7,f,Jenny.jpg,pieFS2.bmp,Jenny illegally parks in the disabled parking spots when she can.,1,reputation,703500,706878,3378,z,1
204059,47,5,1,9,10,f,Janet.jpg,pieFS5.bmp,Janet works as a cleaner in a hotel,2,na,718966,721492,2526,m,0
204059,48,1,8,8,16,m,Sam.jpg,pieFS1.bmp,Sam lost his life savings when his small business failed,2,na,733580,735617,2037,z,1
204059,49,4,2,8,10,m,Ben.jpg,pieFS4.bmp,Ben cheated on his taxes and is now under investigation for tax fraud.,1,reputation,747710,749743,2033,m,0
204059,50,3,5,11,16,f,Fay.jpg,pieFS3.bmp,Fay's husband is a wealthy investment banker,1,resources,761839,763713,1874,z,1
204059,51,5,2,18,20,m,Brad.jpg,pieFS5.bmp,Brad is a veteran having trouble finding employment.,2,na,775801,778307,2506,m,0
204059,52,5,2,18,20,m,Saul.jpg,pieFS5.bmp,Saul stole his elderly father's prescription medications.,1,reputation,790398,792589,2191,m,0
206270,1,2,6,9,15,m,Peter.jpg,pieFS2.bmp,Peter was mugged and had his wallet stolen.,2,na,55254,57933,2679,q,1
206270,2,4,1,4,5,m,Mark.jpg,pieFS4.bmp,Mark often goes through and steals the neighbors' mail.,1,reputation,70137,76673,6536,p,0
206270,3,2,3,4,7,m,Brad.jpg,pieFS2.bmp,Brad has been unable to find a job for over a year.,2,na,88867,90793,1926,q,1
206270,4,4,3,12,15,m,Don.jpg,pieFS4.bmp,Don lost his house in a fire,2,na,102968,135237,32269,p,0
206270,5,4,4,16,20,f,Joanna.jpg,pieFS4.bmp,Joanna illegally parks in the disabled parking spots when she can.,1,reputation,147402,149675,2273,p,0
206270,6,2,3,4,7,f,Trish.jpg,pieFS2.bmp,Trish received a large inheritance from a distant relative,1,resources,161869,163015,1146,q,1
206270,7,1,9,9,18,m,Tony.jpg,pieFS1.bmp,Tony just found $50 on the street,1,resources,175188,177156,1968,q,1
206270,8,4,2,8,10,f,Jackie.jpg,pieFS4.bmp,Jackie's car with her bag and credit cards was recently stolen.,2,na,189323,190836,1513,q,1
206270,9,5,1,9,10,m,Saul.jpg,pieFS5.bmp,Saul is homeless,2,na,202991,203816,825,q,1
206270,10,4,2,8,10,m,Daniel.jpg,pieFS4.bmp,Daniel underreports his company's earnings and pockets the profits.,1,reputation,216010,218717,2707,p,0
206270,11,3,2,4,6,f,Eileen.jpg,pieFS3.bmp,Eileen just found out that her husband has incurred a large credit card debt.,2,na,230893,231897,1004,q,1
206270,12,1,8,8,16,m,Michael.jpg,pieFS1.bmp,Michael is saving to pay his university fees,2,na,244046,244917,871,q,1
206270,13,3,3,7,10,m,Paul.jpg,pieFS3.bmp,Paul is a well paid lawyer,1,resources,257065,258398,1333,q,1
206270,14,4,2,8,10,m,Stuart.jpg,pieFS4.bmp,Stuart lives in a luxury penthouse apartment,1,resources,270550,271938,1388,q,1
206270,15,3,6,14,20,m,Jared.jpg,pieFS3.bmp,Jared is a retiree,2,na,284085,286499,2414,q,1
206270,16,3,5,11,16,f,Sammy.jpg,pieFS3.bmp,Sammy is a highly paid actress,1,resources,298652,299759,1107,q,1
206270,17,4,3,12,15,f,Janet.jpg,pieFS4.bmp,Janet is a single mother,2,na,311921,312799,878,q,1
206270,18,4,4,16,20,f,Arianna.jpg,pieFS4.bmp,Arianna just won the lottery,1,resources,324956,325680,724,q,1
206270,19,4,1,4,5,f,Emily.jpg,pieFS4.bmp,Emily has to take an unpaid leave of absence because her mother broke her hip.,2,na,337842,338820,978,q,1
206270,20,2,6,9,15,m,Justin.jpg,pieFS2.bmp,Justin just bought an expensive sports car,1,resources,350978,352180,1202,q,1
206270,21,3,2,4,6,f,Fiona.jpg,pieFS3.bmp,Fiona cannot afford to send her son to college.,2,na,364330,364821,491,q,1
206270,22,5,1,9,10,f,Kelly.jpg,pieFS5.bmp,Kelly got a large cash bonus from her boss,1,resources,376982,378721,1739,q,1
206270,23,5,2,18,20,f,Louise.jpg,pieFS5.bmp,Louise regularly fires employees to avoid promoting them.,1,reputation,390884,393341,2457,p,0
206270,24,3,3,7,10,f,Jenny.jpg,pieFS3.bmp,Jenny was a victim of identity theft and is now thousands of dollars in debt.,2,na,405518,406402,884,q,1
206270,25,5,1,9,10,m,Matt.jpg,pieFS5.bmp,Matt stole money from his mother's wallet.,1,reputation,418570,419082,512,p,0
206270,26,3,2,4,6,f,Marny.jpg,pieFS3.bmp,Marny works two waitressing jobs to pay her bills.,2,na,431256,431662,406,q,1
206270,27,3,6,14,20,m,Darnell.jpg,pieFS3.bmp,Darnell lost his life savings when his small business failed,2,na,443859,444583,724,q,1
206270,28,2,8,12,20,f,Cindy.jpg,pieFS2.bmp,Cindy just received a huge cash settlement,1,resources,456744,457443,699,q,1
206270,29,5,1,9,10,f,Sharon.jpg,pieFS5.bmp,Sharon secretly gambles with her husband's savings.,1,reputation,469614,471563,1949,p,0
206270,30,5,1,9,10,f,Miriam.jpg,pieFS5.bmp,Miriam claims false expenses for her reportable work travel.,1,reputation,483748,485284,1536,p,0
206270,31,4,4,16,20,m,George.jpg,pieFS4.bmp,George is saving for his son's operation,2,na,497483,497924,441,q,1
206270,32,3,4,9,13,m,Ben.jpg,pieFS3.bmp,Ben cheated on his taxes and is now under investigation for tax fraud.,1,reputation,510119,510725,606,p,0
206270,33,5,1,9,10,f,Kay.jpg,pieFS5.bmp,Kay works as a cleaner in a hotel,2,na,522888,523385,497,q,1
206270,34,5,2,18,20,m,Jack.jpg,pieFS5.bmp,Jack is a veteran having trouble finding employment.,2,na,535541,536045,504,q,1
206270,35,4,3,12,15,m,Taymar.jpg,pieFS4.bmp,Taymar bullies his employees to put in extra hours at work.,1,reputation,548227,549725,1498,p,0
206270,36,5,1,9,10,f,Jean.jpg,pieFS5.bmp,Jean takes discarded food from grocery stores to feed her children.,2,na,561912,562526,614,q,1
206270,37,3,4,9,13,m,Kevin.jpg,pieFS3.bmp,Kevin stole his elderly father's prescription medications.,1,reputation,574748,577426,2678,p,0
206270,38,5,1,9,10,m,Edward.jpg,pieFS5.bmp,Edward just lost his job,2,na,589648,590106,458,q,1
206270,39,5,2,18,20,m,Joe.jpg,pieFS5.bmp,Joe employs illegal immigrants and pays them less than minimum wage.,1,reputation,602334,603287,953,p,0
206270,40,4,1,4,5,m,Alan.jpg,pieFS4.bmp,Alan could not afford his mortgage and his home was foreclosed.,2,na,615519,617807,2288,q,1
206270,41,5,2,18,20,m,Ricky.jpg,pieFS5.bmp,Ricky is hiding his taxable income in Switzerland.,1,reputation,630037,630508,471,p,0
206270,42,4,3,12,15,f,Beth.jpg,pieFS4.bmp,Beth's husband is a wealthy investment banker,1,resources,642740,643348,608,q,1
206270,43,2,7,10,17,f,Emma.jpg,pieFS2.bmp,Emma can't afford to pay her medical bills,2,na,655575,655968,393,q,1
206270,44,5,2,18,20,m,Nick.jpg,pieFS5.bmp,Nick declared bankruptcy after he was laid off.,2,na,668195,668689,494,q,1
206270,45,3,4,9,13,m,Ian.jpg,pieFS3.bmp,Ian takes valuables from his friends' homes when asked to house-sit.,1,reputation,680914,681429,515,p,0
206270,46,4,2,8,10,f,Fay.jpg,pieFS4.bmp,Fay is going to be evicted because she is behind on her rent,2,na,693633,694389,756,q,1
206270,47,1,5,5,10,f,Maria.jpg,pieFS1.bmp,Maria steals her coworkers' tips to buy alcohol.,1,reputation,706619,707270,651,p,0
206270,48,1,10,10,20,f,Monica.jpg,pieFS1.bmp,Monica just lost her small business after a franchise moved in next door.,2,na,719505,720510,1005,q,1
206270,49,3,2,4,6,f,Lauren.jpg,pieFS3.bmp,Lauren used her mother's social security number to open a credit card account.,1,reputation,732740,739570,6830,p,0
206270,50,5,1,9,10,f,Deborah.jpg,pieFS5.bmp,Deborah is raising money to buy gifts for children in need.,2,na,751819,752191,372,q,1
206270,51,3,3,7,10,f,Mary.jpg,pieFS3.bmp,Mary owns an international company,1,resources,764422,765151,729,q,1
206270,52,3,5,11,16,m,Sam.jpg,pieFS3.bmp,Sam was injured in a hit-and-run accident and cannot afford his medical bills.,2,na,777374,778031,657,q,1
207224,1,1,8,8,16,m,Michael.jpg,pieFS1.bmp,Michael has been unable to find a job for over a year.,2,na,28313,32745,4432,z,1
207224,2,4,4,16,20,m,Stuart.jpg,pieFS4.bmp,Stuart lost his house in a fire,2,na,44850,47575,2725,z,1
207224,3,3,2,4,6,f,Fiona.jpg,pieFS3.bmp,Fiona just won the lottery,1,resources,59681,61464,1783,z,1
207224,4,5,1,9,10,f,Miriam.jpg,pieFS5.bmp,Miriam cannot afford to send her son to college.,2,na,73576,75418,1842,z,1
207224,5,3,5,11,16,f,Emma.jpg,pieFS3.bmp,Emma regularly fires employees to avoid promoting them.,1,reputation,87505,89499,1994,z,1
207224,6,2,3,4,7,f,Mary.jpg,pieFS2.bmp,Mary secretly gambles with her husband's savings.,1,reputation,101601,103148,1547,z,1
207224,7,4,3,12,15,f,Fay.jpg,pieFS4.bmp,Fay claims false expenses for her reportable work travel.,1,reputation,115245,117490,2245,z,1
207224,8,5,1,9,10,f,Beth.jpg,pieFS5.bmp,Beth works as a cleaner in a hotel,2,na,129575,131403,1828,z,1
207224,9,2,8,12,20,f,Sammy.jpg,pieFS2.bmp,Sammy used her mother's social security number to open a credit card account.,1,reputation,143503,145428,1925,z,1
207224,10,3,3,7,10,f,Joanna.jpg,pieFS3.bmp,Joanna is raising money to buy gifts for children in need.,2,na,157515,159021,1506,z,1
207224,11,5,1,9,10,m,Alan.jpg,pieFS5.bmp,Alan just lost his job,2,na,171093,173646,2553,z,1
207224,12,1,9,9,18,m,Justin.jpg,pieFS1.bmp,Justin employs illegal immigrants and pays them less than minimum wage.,1,reputation,185740,188270,2530,z,1
207224,13,5,1,9,10,f,Cindy.jpg,pieFS5.bmp,Cindy illegally parks in the disabled parking spots when she can.,1,reputation,200354,201582,1228,z,1
207224,14,4,3,12,15,f,Jackie.jpg,pieFS4.bmp,Jackie's car with her bag and credit cards was recently stolen.,2,na,213681,215981,2300,z,1
207224,15,4,2,8,10,f,Lauren.jpg,pieFS4.bmp,Lauren just found out that her husband has incurred a large credit card debt.,2,na,228077,229575,1498,z,1
207224,16,4,4,16,20,f,Janet.jpg,pieFS4.bmp,Janet's husband is a wealthy investment banker,1,resources,241671,242845,1174,z,1
207224,17,3,2,4,6,f,Kay.jpg,pieFS3.bmp,Kay can't afford to pay her medical bills,2,na,254931,256574,1643,z,1
207224,18,3,2,4,6,f,Sharon.jpg,pieFS3.bmp,Sharon is going to be evicted because she is behind on her rent,2,na,268659,270279,1620,z,1
207224,19,5,2,18,20,m,Darnell.jpg,pieFS5.bmp,Darnell just found $50 on the street,1,resources,282370,286029,3659,z,1
207224,20,3,6,14,20,m,Nick.jpg,pieFS3.bmp,Nick is homeless,2,na,298104,299543,1439,z,1
207224,21,5,1,9,10,f,Jean.jpg,pieFS5.bmp,Jean is a highly paid actress,1,resources,311631,312747,1116,z,1
207224,22,5,1,9,10,m,Matt.jpg,pieFS5.bmp,Matt is saving to pay his university fees,2,na,324841,326209,1368,z,1
207224,23,1,5,5,10,f,Arianna.jpg,pieFS1.bmp,Arianna owns an international company,1,resources,338301,340083,1782,z,1
207224,24,4,2,8,10,f,Maria.jpg,pieFS4.bmp,Maria has to take an unpaid leave of absence because her mother broke her hip.,2,na,352180,353583,1403,z,1
207224,25,4,2,8,10,m,Ben.jpg,pieFS4.bmp,Ben lives in a luxury penthouse apartment,1,resources,365673,367101,1428,z,1
207224,26,3,4,9,13,m,Sam.jpg,pieFS3.bmp,Sam stole money from his mother's wallet.,1,reputation,379201,385869,6668,m,0
207224,27,4,3,12,15,m,Taymar.jpg,pieFS4.bmp,Taymar could not afford his mortgage and his home was foreclosed.,2,na,397961,399763,1802,z,1
207224,28,5,1,9,10,m,Daniel.jpg,pieFS5.bmp,Daniel is hiding his taxable income in Switzerland.,1,reputation,411856,413496,1640,z,1
207224,29,4,2,8,10,m,Edward.jpg,pieFS4.bmp,Edward underreports his company's earnings and pockets the profits.,1,reputation,425584,428655,3071,z,1
207224,30,5,2,18,20,f,Louise.jpg,pieFS5.bmp,Louise received a large inheritance from a distant relative,1,resources,440750,442511,1761,z,1
207224,31,3,5,11,16,m,Don.jpg,pieFS3.bmp,Don lost his life savings when his small business failed,2,na,454612,456742,2130,z,1
207224,32,5,2,18,20,m,Tony.jpg,pieFS5.bmp,Tony cheated on his taxes and is now under investigation for tax fraud.,1,reputation,468841,472247,3406,z,1
207224,33,4,4,16,20,f,Monica.jpg,pieFS4.bmp,Monica got a large cash bonus from her boss,1,resources,484341,486909,2568,z,1
207224,34,3,6,14,20,m,Mark.jpg,pieFS3.bmp,Mark is a veteran having trouble finding employment.,2,na,499006,505040,6034,z,1
207224,35,3,4,9,13,m,Brad.jpg,pieFS3.bmp,Brad stole his elderly father's prescription medications.,1,reputation,517131,521746,4615,z,1
207224,36,2,3,4,7,m,Saul.jpg,pieFS2.bmp,Saul declared bankruptcy after he was laid off.,2,na,533835,537827,3992,z,1
207224,37,4,1,4,5,m,Kevin.jpg,pieFS4.bmp,Kevin takes valuables from his friends' homes when asked to house-sit.,1,reputation,549921,555944,6023,z,1
207224,38,5,1,9,10,f,Trish.jpg,pieFS5.bmp,Trish is a single mother,2,na,568029,570156,2127,z,1
207224,39,3,4,9,13,m,Paul.jpg,pieFS3.bmp,Paul is a well paid lawyer,1,resources,582225,583655,1430,z,1
207224,40,2,6,9,15,m,Jared.jpg,pieFS2.bmp,Jared is a retiree,2,na,595736,598875,3139,z,1
207224,41,4,1,4,5,m,Peter.jpg,pieFS4.bmp,Peter was injured in a hit-and-run accident and cannot afford his medical bills.,2,na,610969,615698,4729,z,1
207224,42,2,7,10,17,f,Kelly.jpg,pieFS2.bmp,Kelly was a victim of identity theft and is now thousands of dollars in debt.,2,na,627790,630941,3151,z,1
207224,43,3,2,4,6,f,Emily.jpg,pieFS3.bmp,Emily works two waitressing jobs to pay her bills.,2,na,643039,644722,1683,z,1
207224,44,2,6,9,15,m,George.jpg,pieFS2.bmp,George just bought an expensive sports car,1,resources,656817,658686,1869,z,1
207224,45,5,2,18,20,m,Joe.jpg,pieFS5.bmp,Joe is saving for his son's operation,2,na,670779,673933,3154,z,1
207224,46,5,1,9,10,f,Eileen.jpg,pieFS5.bmp,Eileen just received a huge cash settlement,1,resources,686029,688202,2173,z,1
207224,47,4,1,4,5,f,Deborah.jpg,pieFS4.bmp,Deborah takes discarded food from grocery stores to feed her children.,2,na,700292,702714,2422,z,1
207224,48,3,3,7,10,f,Jenny.jpg,pieFS3.bmp,Jenny steals her coworkers' tips to buy alcohol.,1,reputation,714805,719940,5135,z,1
207224,49,5,2,18,20,m,Jack.jpg,pieFS5.bmp,Jack was mugged and had his wallet stolen.,2,na,732028,734081,2053,z,1
207224,50,4,3,12,15,m,Ian.jpg,pieFS4.bmp,Ian often goes through and steals the neighbors' mail.,1,reputation,746174,750974,4800,z,1
207224,51,1,10,10,20,f,Marny.jpg,pieFS1.bmp,Marny just lost her small business after a franchise moved in next door.,2,na,763062,766592,3530,z,1
207224,52,3,3,7,10,m,Ricky.jpg,pieFS3.bmp,Ricky bullies his employees to put in extra hours at work.,1,reputation,778679,781718,3039,z,1
208427,1,4,3,12,15,f,Lauren.jpg,pieFS4.bmp,Lauren's car with her bag and credit cards was recently stolen.,2,na,84895,87335,2440,q,1
208427,2,3,4,9,13,m,Ricky.jpg,pieFS3.bmp,Ricky employs illegal immigrants and pays them less than minimum wage.,1,reputation,99595,104275,4680,p,0
208427,3,5,1,9,10,m,Joe.jpg,pieFS5.bmp,Joe could not afford his mortgage and his home was foreclosed.,2,na,116543,118355,1812,q,1
208427,4,5,1,9,10,f,Miriam.jpg,pieFS5.bmp,Miriam can't afford to pay her medical bills,2,na,130627,132055,1428,q,1
208427,5,5,1,9,10,m,Don.jpg,pieFS5.bmp,Don declared bankruptcy after he was laid off.,2,na,144312,145475,1163,q,1
208427,6,3,3,7,10,m,Jared.jpg,pieFS3.bmp,Jared is hiding his taxable income in Switzerland.,1,reputation,157746,158875,1129,p,0
208427,7,2,7,10,17,f,Jackie.jpg,pieFS2.bmp,Jackie just found out that her husband has incurred a large credit card debt.,2,na,171131,173995,2864,q,1
208427,8,1,9,9,18,m,Mark.jpg,pieFS1.bmp,Mark takes valuables from his friends' homes when asked to house-sit.,1,reputation,186248,188435,2187,q,1
208427,9,4,2,8,10,f,Kay.jpg,pieFS4.bmp,Kay is going to be evicted because she is behind on her rent,2,na,200665,201815,1150,p,0
208427,10,2,6,9,15,m,Stuart.jpg,pieFS2.bmp,Stuart was injured in a hit-and-run accident and cannot afford his medical bills.,2,na,214050,216935,2885,q,1
208427,11,1,5,5,10,f,Deborah.jpg,pieFS1.bmp,Deborah is a highly paid actress,1,resources,229150,231655,2505,q,1
208427,12,4,3,12,15,m,Brad.jpg,pieFS4.bmp,Brad was mugged and had his wallet stolen.,2,na,243883,246755,2872,q,1
208427,13,4,2,8,10,m,Justin.jpg,pieFS4.bmp,Justin underreports his company's earnings and pockets the profits.,1,reputation,258966,260076,1110,p,0
208427,14,3,3,7,10,f,Eileen.jpg,pieFS3.bmp,Eileen has to take an unpaid leave of absence because her mother broke her hip.,2,na,272284,273916,1632,q,1
208427,15,4,2,8,10,m,Tony.jpg,pieFS4.bmp,Tony often goes through and steals the neighbors' mail.,1,reputation,286119,287656,1537,p,0
208427,16,3,4,9,13,m,Daniel.jpg,pieFS3.bmp,Daniel is a well paid lawyer,1,resources,299887,301336,1449,q,1
208427,17,5,2,18,20,m,Ben.jpg,pieFS5.bmp,Ben has been unable to find a job for over a year.,2,na,313555,315276,1721,q,1
208427,18,1,8,8,16,m,Nick.jpg,pieFS1.bmp,Nick lost his house in a fire,2,na,327506,329496,1990,q,1
208427,19,3,3,7,10,f,Janet.jpg,pieFS3.bmp,Janet owns an international company,1,resources,341723,344596,2873,q,1
208427,20,5,2,18,20,m,Alan.jpg,pieFS5.bmp,Alan is a retiree,2,na,356806,359876,3070,p,0
208427,21,4,1,4,5,m,George.jpg,pieFS4.bmp,George just bought an expensive sports car,1,resources,372105,374716,2611,p,0
208427,22,4,3,12,15,f,Joanna.jpg,pieFS4.bmp,Joanna got a large cash bonus from her boss,1,resources,386939,389776,2837,p,0
208427,23,4,1,4,5,m,Taymar.jpg,pieFS4.bmp,Taymar is saving for his son's operation,2,na,401989,403216,1227,q,1
208427,24,5,1,9,10,f,Arianna.jpg,pieFS5.bmp,Arianna received a large inheritance from a distant relative,1,resources,415440,418096,2656,p,0
208427,25,5,1,9,10,f,Jenny.jpg,pieFS5.bmp,Jenny was a victim of identity theft and is now thousands of dollars in debt.,2,na,430307,431816,1509,q,1
208427,26,2,6,9,15,m,Peter.jpg,pieFS2.bmp,Peter just found $50 on the street,1,resources,444025,446616,2591,q,1
208427,27,2,3,4,7,m,Sam.jpg,pieFS2.bmp,Sam is homeless,2,na,458841,460136,1295,q,1
208427,28,5,1,9,10,f,Beth.jpg,pieFS5.bmp,Beth is a single mother,2,na,472359,474696,2337,q,1
208427,29,5,2,18,20,m,Edward.jpg,pieFS5.bmp,Edward bullies his employees to put in extra hours at work.,1,reputation,486910,489277,2367,p,0
208427,30,4,2,8,10,f,Cindy.jpg,pieFS4.bmp,Cindy works two waitressing jobs to pay her bills.,2,na,501510,502896,1386,q,1
208427,31,2,3,4,7,f,Emma.jpg,pieFS2.bmp,Emma just won the lottery,1,resources,515145,517477,2332,q,1
208427,32,3,2,4,6,f,Fay.jpg,pieFS3.bmp,Fay cannot afford to send her son to college.,2,na,529712,531637,1925,q,1
208427,33,4,4,16,20,f,Trish.jpg,pieFS4.bmp,Trish regularly fires employees to avoid promoting them.,1,reputation,543846,546077,2231,p,0
208427,34,5,2,18,20,f,Sharon.jpg,pieFS5.bmp,Sharon secretly gambles with her husband's savings.,1,reputation,558296,562357,4061,p,0
208427,35,3,6,14,20,m,Kevin.jpg,pieFS3.bmp,Kevin is saving to pay his university fees,2,na,574578,576117,1539,q,1
208427,36,3,4,9,13,m,Matt.jpg,pieFS3.bmp,Matt lives in a luxury penthouse apartment,1,resources,588346,592157,3811,q,1
208427,37,5,1,9,10,m,Darnell.jpg,pieFS5.bmp,Darnell stole money from his mother's wallet.,1,reputation,604394,607117,2723,p,0
208427,38,2,8,12,20,f,Jean.jpg,pieFS2.bmp,Jean just received a huge cash settlement,1,resources,619344,622217,2873,q,1
208427,39,3,5,11,16,m,Saul.jpg,pieFS3.bmp,Saul lost his life savings when his small business failed,2,na,634444,635937,1493,q,1
208427,40,4,1,4,5,f,Sammy.jpg,pieFS4.bmp,Sammy takes discarded food from grocery stores to feed her children.,2,na,648195,650457,2262,q,1
208427,41,5,2,18,20,m,Ian.jpg,pieFS5.bmp,Ian cheated on his taxes and is now under investigation for tax fraud.,1,reputation,662679,664117,1438,p,0
208427,42,3,5,11,16,f,Monica.jpg,pieFS3.bmp,Monica steals her coworkers' tips to buy alcohol.,1,reputation,676347,680537,4190,p,0
208427,43,3,2,4,6,f,Emily.jpg,pieFS3.bmp,Emily just lost her small business after a franchise moved in next door.,2,na,692745,693938,1193,q,1
208427,44,3,6,14,20,m,Jack.jpg,pieFS3.bmp,Jack is a veteran having trouble finding employment.,2,na,706147,707937,1790,q,1
208427,45,5,1,9,10,f,Marny.jpg,pieFS5.bmp,Marny used her mother's social security number to open a credit card account.,1,reputation,720147,721617,1470,p,0
208427,46,4,3,12,15,m,Michael.jpg,pieFS4.bmp,Michael stole his elderly father's prescription medications.,1,reputation,733849,735257,1408,p,0
208427,47,3,2,4,6,f,Kelly.jpg,pieFS3.bmp,Kelly is raising money to buy gifts for children in need.,2,na,747483,748917,1434,p,0
208427,48,4,4,16,20,f,Maria.jpg,pieFS4.bmp,Maria illegally parks in the disabled parking spots when she can.,1,reputation,761135,763977,2842,q,1
208427,49,3,2,4,6,f,Mary.jpg,pieFS3.bmp,Mary claims false expenses for her reportable work travel.,1,reputation,776201,778698,2497,p,0
208427,50,1,10,10,20,f,Louise.jpg,pieFS1.bmp,Louise works as a cleaner in a hotel,2,na,790918,793338,2420,q,1
208427,51,5,1,9,10,f,Fiona.jpg,pieFS5.bmp,Fiona's husband is a wealthy investment banker,1,resources,805551,807558,2007,p,0
208427,52,4,4,16,20,m,Paul.jpg,pieFS4.bmp,Paul just lost his job,2,na,819785,821258,1473,q,1
208510,1,5,2,18,20,m,Jared.jpg,pieFS5.bmp,Jared underreports his company's earnings and pockets the profits.,1,reputation,44724,49684,4960,p,0
208510,2,4,4,16,20,f,Janet.jpg,pieFS4.bmp,Janet's husband is a wealthy investment banker,1,resources,61938,64684,2746,p,0
208510,3,5,1,9,10,f,Marny.jpg,pieFS5.bmp,Marny illegally parks in the disabled parking spots when she can.,1,reputation,76922,79365,2443,p,0
208510,4,3,5,11,16,m,Peter.jpg,pieFS3.bmp,Peter was mugged and had his wallet stolen.,2,na,91622,95325,3703,q,1
208510,5,5,1,9,10,f,Arianna.jpg,pieFS5.bmp,Arianna can't afford to pay her medical bills,2,na,107587,110085,2498,p,0
208510,6,3,4,9,13,m,Mark.jpg,pieFS3.bmp,Mark often goes through and steals the neighbors' mail.,1,reputation,122338,125425,3087,p,0
208510,7,4,3,12,15,f,Kay.jpg,pieFS4.bmp,Kay is going to be evicted because she is behind on her rent,2,na,137687,140725,3038,p,0
208510,8,2,8,12,20,f,Fay.jpg,pieFS2.bmp,Fay owns an international company,1,resources,153003,156225,3222,q,1
208510,9,1,5,5,10,f,Beth.jpg,pieFS1.bmp,Beth received a large inheritance from a distant relative,1,resources,168503,171926,3423,p,0
208510,10,5,2,18,20,m,Don.jpg,pieFS5.bmp,Don has been unable to find a job for over a year.,2,na,184202,187045,2843,p,0
208510,11,2,3,4,7,m,Sam.jpg,pieFS2.bmp,Sam lost his house in a fire,2,na,199318,202346,3028,p,0
208510,12,3,3,7,10,f,Fiona.jpg,pieFS3.bmp,Fiona is a single mother,2,na,214601,217006,2405,p,0
208510,13,5,1,9,10,f,Louise.jpg,pieFS5.bmp,Louise just won the lottery,1,resources,229268,231746,2478,p,0
208510,14,2,7,10,17,f,Jean.jpg,pieFS2.bmp,Jean's car with her bag and credit cards was recently stolen.,2,na,244018,248426,4408,q,1
208510,15,3,2,4,6,f,Joanna.jpg,pieFS3.bmp,Joanna just found out that her husband has incurred a large credit card debt.,2,na,260700,264426,3726,p,0
208510,16,2,6,9,15,m,George.jpg,pieFS2.bmp,George is a well paid lawyer,1,resources,276698,279566,2868,q,1
208510,17,4,3,12,15,f,Maria.jpg,pieFS4.bmp,Maria is a highly paid actress,1,resources,291848,293387,1539,p,0
208510,18,4,2,8,10,f,Kelly.jpg,pieFS4.bmp,Kelly has to take an unpaid leave of absence because her mother broke her hip.,2,na,305649,309107,3458,p,0
208510,19,3,5,11,16,f,Jackie.jpg,pieFS3.bmp,Jackie got a large cash bonus from her boss,1,resources,321365,324367,3002,q,1
208510,20,1,8,8,16,m,Alan.jpg,pieFS1.bmp,Alan is a retiree,2,na,336648,338787,2139,q,1
208510,21,5,2,18,20,m,Daniel.jpg,pieFS5.bmp,Daniel just bought an expensive sports car,1,resources,351065,353387,2322,p,0
208510,22,4,1,4,5,f,Deborah.jpg,pieFS4.bmp,Deborah was a victim of identity theft and is now thousands of dollars in debt.,2,na,365666,369168,3502,p,0
208510,23,1,10,10,20,f,Cindy.jpg,pieFS1.bmp,Cindy works two waitressing jobs to pay her bills.,2,na,381431,384708,3277,q,1
208510,24,3,4,9,13,m,Matt.jpg,pieFS3.bmp,Matt just found $50 on the street,1,resources,396981,400288,3307,p,0
208510,25,5,2,18,20,m,Tony.jpg,pieFS5.bmp,Tony is homeless,2,na,412546,415048,2502,p,0
208510,26,4,3,12,15,m,Nick.jpg,pieFS4.bmp,Nick is saving to pay his university fees,2,na,427313,428808,1495,p,0
208510,27,4,4,16,20,f,Sammy.jpg,pieFS4.bmp,Sammy just received a huge cash settlement,1,resources,441081,442968,1887,p,0
208510,28,5,1,9,10,f,Mary.jpg,pieFS5.bmp,Mary cannot afford to send her son to college.,2,na,455249,457648,2399,p,0
208510,29,3,2,4,6,f,Eileen.jpg,pieFS3.bmp,Eileen takes discarded food from grocery stores to feed her children.,2,na,469916,472969,3053,p,0
208510,30,4,2,8,10,m,Ian.jpg,pieFS4.bmp,Ian lives in a luxury penthouse apartment,1,resources,485249,488089,2840,p,0
208510,31,3,3,7,10,f,Emma.jpg,pieFS3.bmp,Emma regularly fires employees to avoid promoting them.,1,reputation,500348,503429,3081,p,0
208510,32,5,1,9,10,f,Sharon.jpg,pieFS5.bmp,Sharon secretly gambles with her husband's savings.,1,reputation,515698,518389,2691,p,0
208510,33,1,9,9,18,m,Ben.jpg,pieFS1.bmp,Ben stole money from his mother's wallet.,1,reputation,530648,534130,3482,q,1
208510,34,2,3,4,7,f,Monica.jpg,pieFS2.bmp,Monica steals her coworkers' tips to buy alcohol.,1,reputation,546380,548729,2349,p,0
208510,35,2,6,9,15,m,Michael.jpg,pieFS2.bmp,Michael lost his life savings when his small business failed,2,na,560964,564889,3925,q,1
208510,36,4,2,8,10,m,Stuart.jpg,pieFS4.bmp,Stuart cheated on his taxes and is now under investigation for tax fraud.,1,reputation,577146,580030,2884,p,0
208510,37,5,1,9,10,m,Kevin.jpg,pieFS5.bmp,Kevin is a veteran having trouble finding employment.,2,na,592279,595010,2731,p,0
208510,38,3,2,4,6,f,Lauren.jpg,pieFS3.bmp,Lauren just lost her small business after a franchise moved in next door.,2,na,607279,609750,2471,p,0
208510,39,5,1,9,10,m,Taymar.jpg,pieFS5.bmp,Taymar is saving for his son's operation,2,na,621996,623831,1835,p,0
208510,40,3,2,4,6,f,Miriam.jpg,pieFS3.bmp,Miriam claims false expenses for her reportable work travel.,1,reputation,636113,639730,3617,p,0
208510,41,3,3,7,10,m,Brad.jpg,pieFS3.bmp,Brad stole his elderly father's prescription medications.,1,reputation,651996,653650,1654,p,0
208510,42,4,3,12,15,m,Joe.jpg,pieFS4.bmp,Joe bullies his employees to put in extra hours at work.,1,reputation,665913,668690,2777,p,0
208510,43,5,2,18,20,f,Jenny.jpg,pieFS5.bmp,Jenny used her mother's social security number to open a credit card account.,1,reputation,680963,683131,2168,p,0
208510,44,5,1,9,10,f,Emily.jpg,pieFS5.bmp,Emily is raising money to buy gifts for children in need.,2,na,695397,697111,1714,p,0
208510,45,3,6,14,20,m,Justin.jpg,pieFS3.bmp,Justin just lost his job,2,na,709365,712291,2926,q,1
208510,46,5,1,9,10,m,Ricky.jpg,pieFS5.bmp,Ricky employs illegal immigrants and pays them less than minimum wage.,1,reputation,724548,727511,2963,p,0
208510,47,4,1,4,5,m,Saul.jpg,pieFS4.bmp,Saul declared bankruptcy after he was laid off.,2,na,739764,743252,3488,p,0
208510,48,4,4,16,20,m,Edward.jpg,pieFS4.bmp,Edward could not afford his mortgage and his home was foreclosed.,2,na,755497,758112,2615,p,0
208510,49,4,2,8,10,f,Trish.jpg,pieFS4.bmp,Trish works as a cleaner in a hotel,2,na,770363,771712,1349,p,0
208510,50,3,4,9,13,m,Jack.jpg,pieFS3.bmp,Jack takes valuables from his friends' homes when asked to house-sit.,1,reputation,783965,788012,4047,p,0
208510,51,3,6,14,20,m,Darnell.jpg,pieFS3.bmp,Darnell was injured in a hit-and-run accident and cannot afford his medical bills.,2,na,800247,803492,3245,q,1
208510,52,4,1,4,5,m,Paul.jpg,pieFS4.bmp,Paul is hiding his taxable income in Switzerland.,1,reputation,815746,818572,2826,p,0
208806,1,5,1,9,10,f,Jenny.jpg,pieFS5.bmp,Jenny just found out that her husband has incurred a large credit card debt.,2,na,90315,94520,4205,q,1
208806,2,1,8,8,16,m,Joe.jpg,pieFS1.bmp,Joe just lost his job,2,na,106714,111120,4406,p,0
208806,3,3,3,7,10,f,Eileen.jpg,pieFS3.bmp,Eileen is a highly paid actress,1,resources,123312,124920,1608,q,1
208806,4,3,4,9,13,m,Kevin.jpg,pieFS3.bmp,Kevin stole money from his mother's wallet.,1,reputation,137113,139360,2247,p,0
208806,5,5,1,9,10,f,Emily.jpg,pieFS5.bmp,Emily has to take an unpaid leave of absence because her mother broke her hip.,2,na,151563,153660,2097,q,1
208806,6,4,4,16,20,f,Kelly.jpg,pieFS4.bmp,Kelly got a large cash bonus from her boss,1,resources,165847,167520,1673,q,1
208806,7,4,2,8,10,f,Marny.jpg,pieFS4.bmp,Marny was a victim of identity theft and is now thousands of dollars in debt.,2,na,179715,181740,2025,q,1
208806,8,3,3,7,10,f,Joanna.jpg,pieFS3.bmp,Joanna works two waitressing jobs to pay her bills.,2,na,193932,195720,1788,q,1
208806,9,2,3,4,7,f,Maria.jpg,pieFS2.bmp,Maria just received a huge cash settlement,1,resources,207917,209300,1383,q,1
208806,10,4,3,12,15,f,Sharon.jpg,pieFS4.bmp,Sharon regularly fires employees to avoid promoting them.,1,reputation,221468,223340,1872,p,0
208806,11,1,9,9,18,m,Edward.jpg,pieFS1.bmp,Edward employs illegal immigrants and pays them less than minimum wage.,1,reputation,235519,237260,1741,q,1
208806,12,3,6,14,20,m,Tony.jpg,pieFS3.bmp,Tony lost his life savings when his small business failed,2,na,249436,251260,1824,q,1
208806,13,5,2,18,20,m,Daniel.jpg,pieFS5.bmp,Daniel could not afford his mortgage and his home was foreclosed.,2,na,263437,267580,4143,p,0
208806,14,4,2,8,10,m,Jack.jpg,pieFS4.bmp,Jack cheated on his taxes and is now under investigation for tax fraud.,1,reputation,279752,281360,1608,q,1
208806,15,2,3,4,7,m,Matt.jpg,pieFS2.bmp,Matt is a veteran having trouble finding employment.,2,na,293520,296380,2860,q,1
208806,16,5,1,9,10,m,Darnell.jpg,pieFS5.bmp,Darnell stole his elderly father's prescription medications.,1,reputation,308537,311260,2723,p,0
208806,17,1,5,5,10,f,Janet.jpg,pieFS1.bmp,Janet secretly gambles with her husband's savings.,1,reputation,323437,325100,1663,q,1
208806,18,3,5,11,16,f,Mary.jpg,pieFS3.bmp,Mary claims false expenses for her reportable work travel.,1,reputation,337271,339840,2569,p,0
208806,19,4,2,8,10,f,Trish.jpg,pieFS4.bmp,Trish works as a cleaner in a hotel,2,na,352038,353981,1943,q,1
208806,20,3,2,4,6,f,Deborah.jpg,pieFS3.bmp,Deborah takes discarded food from grocery stores to feed her children.,2,na,366172,368181,2009,q,1
208806,21,5,2,18,20,m,Peter.jpg,pieFS5.bmp,Peter declared bankruptcy after he was laid off.,2,na,380373,383861,3488,q,1
208806,22,4,1,4,5,m,Sam.jpg,pieFS4.bmp,Sam takes valuables from his friends' homes when asked to house-sit.,1,reputation,396038,399121,3083,p,0
208806,23,5,1,9,10,m,Ian.jpg,pieFS5.bmp,Ian was injured in a hit-and-run accident and cannot afford his medical bills.,2,na,411288,413461,2173,q,1
208806,24,5,1,9,10,f,Sammy.jpg,pieFS5.bmp,Sammy steals her coworkers' tips to buy alcohol.,1,reputation,425622,427161,1539,p,0
208806,25,2,8,12,20,f,Arianna.jpg,pieFS2.bmp,Arianna's husband is a wealthy investment banker,1,resources,439323,440641,1318,q,1
208806,26,3,6,14,20,m,Brad.jpg,pieFS3.bmp,Brad was mugged and had his wallet stolen.,2,na,452791,454021,1230,q,1
208806,27,4,1,4,5,f,Miriam.jpg,pieFS4.bmp,Miriam can't afford to pay her medical bills,2,na,466176,468221,2045,q,1
208806,28,3,3,7,10,m,Taymar.jpg,pieFS3.bmp,Taymar is hiding his taxable income in Switzerland.,1,reputation,480377,481641,1264,q,1
208806,29,4,3,12,15,m,Alan.jpg,pieFS4.bmp,Alan underreports his company's earnings and pockets the profits.,1,reputation,493812,495041,1229,q,1
208806,30,4,3,12,15,f,Kay.jpg,pieFS4.bmp,Kay is going to be evicted because she is behind on her rent,2,na,507197,509401,2204,q,1
208806,31,3,2,4,6,f,Monica.jpg,pieFS3.bmp,Monica just lost her small business after a franchise moved in next door.,2,na,521564,523361,1797,q,1
208806,32,5,2,18,20,m,Nick.jpg,pieFS5.bmp,Nick often goes through and steals the neighbors' mail.,1,reputation,535531,537261,1730,p,0
208806,33,2,6,9,15,m,Ricky.jpg,pieFS2.bmp,Ricky is a well paid lawyer,1,resources,549416,550781,1365,q,1
208806,34,5,1,9,10,f,Fiona.jpg,pieFS5.bmp,Fiona owns an international company,1,resources,562951,564661,1710,p,0
208806,35,4,4,16,20,m,Saul.jpg,pieFS4.bmp,Saul has been unable to find a job for over a year.,2,na,576818,578001,1183,q,1
208806,36,5,1,9,10,m,Paul.jpg,pieFS5.bmp,Paul is a retiree,2,na,590153,593161,3008,q,1
208806,37,4,3,12,15,m,Michael.jpg,pieFS4.bmp,Michael lost his house in a fire,2,na,605320,606521,1201,q,1
208806,38,4,4,16,20,f,Lauren.jpg,pieFS4.bmp,Lauren used her mother's social security number to open a credit card account.,1,reputation,618688,620961,2273,q,1
208806,39,5,2,18,20,f,Beth.jpg,pieFS5.bmp,Beth received a large inheritance from a distant relative,1,resources,633122,634581,1459,p,0
208806,40,3,2,4,6,f,Fay.jpg,pieFS3.bmp,Fay is a single mother,2,na,646740,647981,1241,q,1
208806,41,4,2,8,10,m,Jared.jpg,pieFS4.bmp,Jared just bought an expensive sports car,1,resources,660141,662881,2740,q,1
208806,42,5,1,9,10,f,Jean.jpg,pieFS5.bmp,Jean is raising money to buy gifts for children in need.,2,na,675041,676922,1881,p,0
208806,43,3,2,4,6,f,Louise.jpg,pieFS3.bmp,Louise just won the lottery,1,resources,689075,690202,1127,q,1
208806,44,3,5,11,16,m,Justin.jpg,pieFS3.bmp,Justin is saving for his son's operation,2,na,702361,704182,1821,q,1
208806,45,3,4,9,13,m,Stuart.jpg,pieFS3.bmp,Stuart just found $50 on the street,1,resources,716361,717742,1381,q,1
208806,46,5,1,9,10,f,Jackie.jpg,pieFS5.bmp,Jackie illegally parks in the disabled parking spots when she can.,1,reputation,729913,731562,1649,p,0
208806,47,4,1,4,5,m,Don.jpg,pieFS4.bmp,Don is homeless,2,na,743714,745162,1448,q,1
208806,48,2,7,10,17,f,Cindy.jpg,pieFS2.bmp,Cindy's car with her bag and credit cards was recently stolen.,2,na,757315,759062,1747,q,1
208806,49,2,6,9,15,m,Mark.jpg,pieFS2.bmp,Mark is saving to pay his university fees,2,na,771216,772582,1366,q,1
208806,50,5,2,18,20,m,George.jpg,pieFS5.bmp,George bullies his employees to put in extra hours at work.,1,reputation,784735,786222,1487,p,0
208806,51,3,4,9,13,m,Ben.jpg,pieFS3.bmp,Ben lives in a luxury penthouse apartment,1,resources,798369,799522,1153,q,1
208806,52,1,10,10,20,f,Emma.jpg,pieFS1.bmp,Emma cannot afford to send her son to college.,2,na,811671,813482,1811,q,1
209452,1,5,1,9,10,f,Sharon.jpg,pieFS5.bmp,Sharon claims false expenses for her reportable work travel.,1,reputation,51033,58010,6977,p,0
209452,2,5,1,9,10,m,Justin.jpg,pieFS5.bmp,Justin just lost his job,2,na,70211,75030,4819,q,1
209452,3,3,2,4,6,f,Monica.jpg,pieFS3.bmp,Monica illegally parks in the disabled parking spots when she can.,1,reputation,87226,93730,6504,p,0
209452,4,3,2,4,6,f,Cindy.jpg,pieFS3.bmp,Cindy's car with her bag and credit cards was recently stolen.,2,na,105905,110071,4166,q,1
209452,5,4,1,4,5,f,Jackie.jpg,pieFS4.bmp,Jackie just found out that her husband has incurred a large credit card debt.,2,na,122237,126151,3914,q,1
209452,6,2,6,9,15,m,Joe.jpg,pieFS2.bmp,Joe employs illegal immigrants and pays them less than minimum wage.,1,reputation,138335,144191,5856,p,0
209452,7,4,4,16,20,f,Emily.jpg,pieFS4.bmp,Emily is a highly paid actress,1,resources,156349,163731,7382,q,1
209452,8,5,1,9,10,f,Trish.jpg,pieFS5.bmp,Trish works as a cleaner in a hotel,2,na,175877,180351,4474,q,1
209452,9,4,4,16,20,f,Emma.jpg,pieFS4.bmp,Emma's husband is a wealthy investment banker,1,resources,192525,197931,5406,q,1
209452,10,4,3,12,15,f,Miriam.jpg,pieFS4.bmp,Miriam can't afford to pay her medical bills,2,na,210089,212172,2083,q,1
209452,11,4,1,4,5,m,Ian.jpg,pieFS4.bmp,Ian cheated on his taxes and is now under investigation for tax fraud.,1,reputation,224339,229072,4733,p,0
209452,12,1,8,8,16,m,Ricky.jpg,pieFS1.bmp,Ricky could not afford his mortgage and his home was foreclosed.,2,na,241237,243492,2255,q,1
209452,13,3,2,4,6,f,Sammy.jpg,pieFS3.bmp,Sammy has to take an unpaid leave of absence because her mother broke her hip.,2,na,255638,258092,2454,q,1
209452,14,2,6,9,15,m,Jack.jpg,pieFS2.bmp,Jack is a veteran having trouble finding employment.,2,na,270238,272412,2174,q,1
209452,15,4,3,12,15,m,Jared.jpg,pieFS4.bmp,Jared is hiding his taxable income in Switzerland.,1,reputation,284589,287352,2763,p,0
209452,16,3,3,7,10,m,Nick.jpg,pieFS3.bmp,Nick stole his elderly father's prescription medications.,1,reputation,299505,302972,3467,p,0
209452,17,3,5,11,16,f,Kelly.jpg,pieFS3.bmp,Kelly got a large cash bonus from her boss,1,resources,315121,317392,2271,q,1
209452,18,5,2,18,20,m,Sam.jpg,pieFS5.bmp,Sam declared bankruptcy after he was laid off.,2,na,329538,334833,5295,p,0
209452,19,4,2,8,10,m,Mark.jpg,pieFS4.bmp,Mark takes valuables from his friends' homes when asked to house-sit.,1,reputation,346986,350953,3967,p,0
209452,20,5,1,9,10,f,Jenny.jpg,pieFS5.bmp,Jenny was a victim of identity theft and is now thousands of dollars in debt.,2,na,363117,365393,2276,q,1
209452,21,4,2,8,10,f,Fay.jpg,pieFS4.bmp,Fay is going to be evicted because she is behind on her rent,2,na,377551,379973,2422,q,1
209452,22,4,2,8,10,f,Lauren.jpg,pieFS4.bmp,Lauren works two waitressing jobs to pay her bills.,2,na,392135,394453,2318,q,1
209452,23,4,3,12,15,m,Kevin.jpg,pieFS4.bmp,Kevin was injured in a hit-and-run accident and cannot afford his medical bills.,2,na,406636,408453,1817,q,1
209452,24,4,4,16,20,m,Matt.jpg,pieFS4.bmp,Matt was mugged and had his wallet stolen.,2,na,420620,422814,2194,q,1
209452,25,5,1,9,10,f,Kay.jpg,pieFS5.bmp,Kay owns an international company,1,resources,434971,440114,5143,p,0
209452,26,1,5,5,10,f,Mary.jpg,pieFS1.bmp,Mary received a large inheritance from a distant relative,1,resources,452268,454114,1846,q,1
209452,27,2,7,10,17,f,Beth.jpg,pieFS2.bmp,Beth is a single mother,2,na,466286,468374,2088,q,1
209452,28,5,2,18,20,f,Marny.jpg,pieFS5.bmp,Marny just received a huge cash settlement,1,resources,480553,484055,3502,p,0
209452,29,4,2,8,10,m,Peter.jpg,pieFS4.bmp,Peter often goes through and steals the neighbors' mail.,1,reputation,496252,498914,2662,p,0
209452,30,3,5,11,16,m,Ben.jpg,pieFS3.bmp,Ben has been unable to find a job for over a year.,2,na,511085,512974,1889,q,1
209452,31,5,1,9,10,m,Don.jpg,pieFS5.bmp,Don lost his house in a fire,2,na,525120,527375,2255,q,1
209452,32,2,3,4,7,f,Arianna.jpg,pieFS2.bmp,Arianna just won the lottery,1,resources,539520,541735,2215,q,1
209452,33,3,2,4,6,f,Louise.jpg,pieFS3.bmp,Louise cannot afford to send her son to college.,2,na,553888,555875,1987,q,1
209452,34,2,8,12,20,f,Fiona.jpg,pieFS2.bmp,Fiona regularly fires employees to avoid promoting them.,1,reputation,568022,571915,3893,p,0
209452,35,5,1,9,10,m,Tony.jpg,pieFS5.bmp,Tony just found $50 on the street,1,resources,584071,587595,3524,p,0
209452,36,5,1,9,10,f,Maria.jpg,pieFS5.bmp,Maria takes discarded food from grocery stores to feed her children.,2,na,599770,604295,4525,q,1
209452,37,4,3,12,15,f,Jean.jpg,pieFS4.bmp,Jean steals her coworkers' tips to buy alcohol.,1,reputation,616451,619436,2985,p,0
209452,38,1,9,9,18,m,Daniel.jpg,pieFS1.bmp,Daniel underreports his company's earnings and pockets the profits.,1,reputation,631584,634696,3112,p,0
209452,39,3,6,14,20,m,Saul.jpg,pieFS3.bmp,Saul is homeless,2,na,646850,649236,2386,q,1
209452,40,3,4,9,13,m,Alan.jpg,pieFS3.bmp,Alan is a well paid lawyer,1,resources,661401,666256,4855,q,1
209452,41,3,6,14,20,m,Brad.jpg,pieFS3.bmp,Brad is saving to pay his university fees,2,na,678448,680556,2108,q,1
209452,42,3,3,7,10,f,Joanna.jpg,pieFS3.bmp,Joanna just lost her small business after a franchise moved in next door.,2,na,692749,695116,2367,q,1
209452,43,2,3,4,7,m,Edward.jpg,pieFS2.bmp,Edward is a retiree,2,na,707300,709676,2376,q,1
209452,44,5,2,18,20,m,Michael.jpg,pieFS5.bmp,Michael lives in a luxury penthouse apartment,1,resources,721833,724797,2964,p,0
209452,45,3,4,9,13,m,Taymar.jpg,pieFS3.bmp,Taymar just bought an expensive sports car,1,resources,736950,741177,4227,p,0
209452,46,5,2,18,20,m,Darnell.jpg,pieFS5.bmp,Darnell stole money from his mother's wallet.,1,reputation,753331,756217,2886,p,0
209452,47,5,1,9,10,f,Deborah.jpg,pieFS5.bmp,Deborah used her mother's social security number to open a credit card account.,1,reputation,768365,770397,2032,p,0
209452,48,4,1,4,5,m,George.jpg,pieFS4.bmp,George is saving for his son's operation,2,na,782549,784197,1648,q,1
209452,49,3,4,9,13,m,Paul.jpg,pieFS3.bmp,Paul bullies his employees to put in extra hours at work.,1,reputation,796350,799917,3567,p,0
209452,50,3,3,7,10,f,Janet.jpg,pieFS3.bmp,Janet secretly gambles with her husband's savings.,1,reputation,812082,814097,2015,p,0
209452,51,5,2,18,20,m,Stuart.jpg,pieFS5.bmp,Stuart lost his life savings when his small business failed,2,na,826250,828218,1968,q,1
209452,52,1,10,10,20,f,Eileen.jpg,pieFS1.bmp,Eileen is raising money to buy gifts for children in need.,2,na,840367,842498,2131,q,1
209468,1,1,9,9,18,m,Don.jpg,pieFS1.bmp,Don takes valuables from his friends' homes when asked to house-sit.,1,reputation,60618,65440,4822,p,0
209468,2,1,8,8,16,m,Nick.jpg,pieFS1.bmp,Nick was injured in a hit-and-run accident and cannot afford his medical bills.,2,na,77733,82401,4668,q,1
209468,3,4,1,4,5,f,Marny.jpg,pieFS4.bmp,Marny was a victim of identity theft and is now thousands of dollars in debt.,2,na,94730,96501,1771,q,1
209468,4,2,3,4,7,m,Jared.jpg,pieFS2.bmp,Jared could not afford his mortgage and his home was foreclosed.,2,na,108815,111481,2666,q,1
209468,5,3,3,7,10,f,Emily.jpg,pieFS3.bmp,Emily works two waitressing jobs to pay her bills.,2,na,123798,125642,1844,q,1
209468,6,3,5,11,16,f,Beth.jpg,pieFS3.bmp,Beth claims false expenses for her reportable work travel.,1,reputation,137949,140642,2693,p,0
209468,7,5,1,9,10,f,Kelly.jpg,pieFS5.bmp,Kelly just received a huge cash settlement,1,resources,152983,157863,4880,q,1
209468,8,3,2,4,6,f,Trish.jpg,pieFS3.bmp,Trish works as a cleaner in a hotel,2,na,170147,171983,1836,q,1
209468,9,4,3,12,15,f,Deborah.jpg,pieFS4.bmp,Deborah takes discarded food from grocery stores to feed her children.,2,na,184282,186123,1841,q,1
209468,10,3,6,14,20,m,Kevin.jpg,pieFS3.bmp,Kevin was mugged and had his wallet stolen.,2,na,198433,200164,1731,q,1
209468,11,4,2,8,10,m,Jack.jpg,pieFS4.bmp,Jack often goes through and steals the neighbors' mail.,1,reputation,212417,214504,2087,p,0
209468,12,4,3,12,15,m,Justin.jpg,pieFS4.bmp,Justin is hiding his taxable income in Switzerland.,1,reputation,226752,229324,2572,p,0
209468,13,4,1,4,5,m,Michael.jpg,pieFS4.bmp,Michael has been unable to find a job for over a year.,2,na,241569,244105,2536,q,1
209468,14,2,8,12,20,f,Jenny.jpg,pieFS2.bmp,Jenny steals her coworkers' tips to buy alcohol.,1,reputation,256352,259445,3093,p,0
209468,15,2,7,10,17,f,Maria.jpg,pieFS2.bmp,Maria just lost her small business after a franchise moved in next door.,2,na,271685,277046,5361,q,1
209468,16,3,4,9,13,m,Taymar.jpg,pieFS3.bmp,Taymar underreports his company's earnings and pockets the profits.,1,reputation,289266,291466,2200,p,0
209468,17,1,5,5,10,f,Joanna.jpg,pieFS1.bmp,Joanna used her mother's social security number to open a credit card account.,1,reputation,303684,305466,1782,p,0
209468,18,4,4,16,20,f,Sharon.jpg,pieFS4.bmp,Sharon's husband is a wealthy investment banker,1,resources,317685,319627,1942,p,0
209468,19,5,2,18,20,m,Paul.jpg,pieFS5.bmp,Paul is a well paid lawyer,1,resources,331852,333667,1815,p,0
209468,20,4,3,12,15,m,Stuart.jpg,pieFS4.bmp,Stuart lost his house in a fire,2,na,345870,347588,1718,q,1
209468,21,5,1,9,10,m,Ricky.jpg,pieFS5.bmp,Ricky is a retiree,2,na,359805,363448,3643,q,1
209468,22,4,2,8,10,f,Fay.jpg,pieFS4.bmp,Fay can't afford to pay her medical bills,2,na,375654,377168,1514,q,1
209468,23,5,1,9,10,m,George.jpg,pieFS5.bmp,George just bought an expensive sports car,1,resources,389372,392149,2777,q,1
209468,24,5,1,9,10,f,Fiona.jpg,pieFS5.bmp,Fiona is going to be evicted because she is behind on her rent,2,na,404389,406329,1940,q,1
209468,25,4,3,12,15,f,Miriam.jpg,pieFS4.bmp,Miriam owns an international company,1,resources,418557,421450,2893,p,0
209468,26,1,10,10,20,f,Cindy.jpg,pieFS1.bmp,Cindy is raising money to buy gifts for children in need.,2,na,433674,435530,1856,q,1
209468,27,3,3,7,10,m,Saul.jpg,pieFS3.bmp,Saul just found $50 on the street,1,resources,447758,449850,2092,q,1
209468,28,5,1,9,10,m,Joe.jpg,pieFS5.bmp,Joe is saving for his son's operation,2,na,462076,464011,1935,q,1
209468,29,3,4,9,13,m,Daniel.jpg,pieFS3.bmp,Daniel bullies his employees to put in extra hours at work.,1,reputation,476227,480031,3804,p,0
209468,30,2,3,4,7,f,Jean.jpg,pieFS2.bmp,Jean illegally parks in the disabled parking spots when she can.,1,reputation,492259,494811,2552,p,0
209468,31,4,4,16,20,m,Ian.jpg,pieFS4.bmp,Ian is homeless,2,na,507076,508992,1916,q,1
209468,32,5,1,9,10,f,Janet.jpg,pieFS5.bmp,Janet received a large inheritance from a distant relative,1,resources,521227,523632,2405,q,1
209468,33,5,2,18,20,m,Peter.jpg,pieFS5.bmp,Peter is saving to pay his university fees,2,na,535861,537613,1752,q,1
209468,34,4,1,4,5,m,Ben.jpg,pieFS4.bmp,Ben lives in a luxury penthouse apartment,1,resources,549845,551613,1768,q,1
209468,35,4,2,8,10,m,Darnell.jpg,pieFS4.bmp,Darnell stole money from his mother's wallet.,1,reputation,563947,565773,1826,p,0
209468,36,2,6,9,15,m,Brad.jpg,pieFS2.bmp,Brad lost his life savings when his small business failed,2,na,578014,579634,1620,q,1
209468,37,5,2,18,20,m,Edward.jpg,pieFS5.bmp,Edward just lost his job,2,na,591882,593774,1892,q,1
209468,38,2,6,9,15,m,Alan.jpg,pieFS2.bmp,Alan employs illegal immigrants and pays them less than minimum wage.,1,reputation,605984,608074,2090,p,0
209468,39,3,2,4,6,f,Arianna.jpg,pieFS3.bmp,Arianna is a single mother,2,na,620301,622035,1734,q,1
209468,40,3,3,7,10,f,Kay.jpg,pieFS3.bmp,Kay just won the lottery,1,resources,634269,636015,1746,q,1
209468,41,5,2,18,20,m,Mark.jpg,pieFS5.bmp,Mark cheated on his taxes and is now under investigation for tax fraud.,1,reputation,648237,650356,2119,p,0
209468,42,5,1,9,10,f,Jackie.jpg,pieFS5.bmp,Jackie's car with her bag and credit cards was recently stolen.,2,na,662588,664236,1648,q,1
209468,43,4,2,8,10,f,Eileen.jpg,pieFS4.bmp,Eileen just found out that her husband has incurred a large credit card debt.,2,na,676456,679076,2620,q,1
209468,44,3,6,14,20,m,Sam.jpg,pieFS3.bmp,Sam is a veteran having trouble finding employment.,2,na,691323,692957,1634,q,1
209468,45,3,2,4,6,f,Louise.jpg,pieFS3.bmp,Louise cannot afford to send her son to college.,2,na,705191,706857,1666,q,1
209468,46,5,1,9,10,f,Lauren.jpg,pieFS5.bmp,Lauren is a highly paid actress,1,resources,719059,721017,1958,q,1
209468,47,5,1,9,10,f,Sammy.jpg,pieFS5.bmp,Sammy has to take an unpaid leave of absence because her mother broke her hip.,2,na,733260,734958,1698,q,1
209468,48,3,4,9,13,m,Tony.jpg,pieFS3.bmp,Tony stole his elderly father's prescription medications.,1,reputation,747178,749078,1900,p,0
209468,49,3,5,11,16,m,Matt.jpg,pieFS3.bmp,Matt declared bankruptcy after he was laid off.,2,na,761296,763438,2142,q,1
209468,50,4,4,16,20,f,Emma.jpg,pieFS4.bmp,Emma regularly fires employees to avoid promoting them.,1,reputation,775663,775779,116,p,0
209468,51,5,2,18,20,f,Monica.jpg,pieFS5.bmp,Monica got a large cash bonus from her boss,1,resources,788016,789539,1523,q,1
209468,52,3,2,4,6,f,Mary.jpg,pieFS3.bmp,Mary secretly gambles with her husband's savings.,1,reputation,801768,803220,1452,p,0
209662,1,5,1,9,10,m,Jared.jpg,pieFS5.bmp,Jared is a retiree,2,na,71982,129931,57949,p,0
209662,2,3,4,9,13,m,Joe.jpg,pieFS3.bmp,Joe just bought an expensive sports car,1,resources,142204,151672,9468,p,0
209662,3,4,2,8,10,f,Jenny.jpg,pieFS4.bmp,Jenny has to take an unpaid leave of absence because her mother broke her hip.,2,na,163913,168672,4759,q,1
209662,4,3,6,14,20,m,Mark.jpg,pieFS3.bmp,Mark was mugged and had his wallet stolen.,2,na,180910,185272,4362,q,1
209662,5,4,1,4,5,m,Edward.jpg,pieFS4.bmp,Edward is saving for his son's operation,2,na,197492,206613,9121,q,1
209662,6,4,2,8,10,m,Brad.jpg,pieFS4.bmp,Brad often goes through and steals the neighbors' mail.,1,reputation,218835,222033,3198,p,0
209662,7,4,3,12,15,f,Deborah.jpg,pieFS4.bmp,Deborah got a large cash bonus from her boss,1,resources,234267,238593,4326,p,0
209662,8,1,5,5,10,f,Fay.jpg,pieFS1.bmp,Fay's husband is a wealthy investment banker,1,resources,250832,256194,5362,q,1
209662,9,3,6,14,20,m,Ben.jpg,pieFS3.bmp,Ben has been unable to find a job for over a year.,2,na,268413,278914,10501,q,1
209662,10,5,1,9,10,m,Tony.jpg,pieFS5.bmp,Tony lost his house in a fire,2,na,291137,293674,2537,q,1
209662,11,3,2,4,6,f,Miriam.jpg,pieFS3.bmp,Miriam can't afford to pay her medical bills,2,na,305904,308694,2790,q,1
209662,12,3,3,7,10,f,Arianna.jpg,pieFS3.bmp,Arianna is going to be evicted because she is behind on her rent,2,na,320904,323514,2610,q,1
209662,13,4,3,12,15,m,Ricky.jpg,pieFS4.bmp,Ricky bullies his employees to put in extra hours at work.,1,reputation,335721,339534,3813,p,0
209662,14,3,2,4,6,f,Janet.jpg,pieFS3.bmp,Janet owns an international company,1,resources,351753,365194,13441,p,0
209662,15,4,2,8,10,m,Nick.jpg,pieFS4.bmp,Nick just found $50 on the street,1,resources,377374,385274,7900,p,0
209662,16,2,6,9,15,m,Don.jpg,pieFS2.bmp,Don is homeless,2,na,397468,402515,5047,q,1
209662,17,4,3,12,15,f,Cindy.jpg,pieFS4.bmp,Cindy was a victim of identity theft and is now thousands of dollars in debt.,2,na,414682,418995,4313,q,1
209662,18,4,3,12,15,m,Peter.jpg,pieFS4.bmp,Peter is saving to pay his university fees,2,na,431147,436915,5768,p,0
209662,19,1,9,9,18,m,Saul.jpg,pieFS1.bmp,Saul lives in a luxury penthouse apartment,1,resources,449077,454615,5538,q,1
209662,20,3,5,11,16,f,Trish.jpg,pieFS3.bmp,Trish received a large inheritance from a distant relative,1,resources,466774,471835,5061,p,0
209662,21,2,6,9,15,m,Ian.jpg,pieFS2.bmp,Ian stole money from his mother's wallet.,1,reputation,483988,486876,2888,p,0
209662,22,1,8,8,16,m,Daniel.jpg,pieFS1.bmp,Daniel just lost his job,2,na,499022,501976,2954,q,1
209662,23,1,10,10,20,f,Jean.jpg,pieFS1.bmp,Jean works two waitressing jobs to pay her bills.,2,na,514121,517556,3435,q,1
209662,24,5,2,18,20,m,Justin.jpg,pieFS5.bmp,Justin employs illegal immigrants and pays them less than minimum wage.,1,reputation,529721,532876,3155,p,0
209662,25,2,8,12,20,f,Monica.jpg,pieFS2.bmp,Monica just received a huge cash settlement,1,resources,545053,548236,3183,p,0
209662,26,2,7,10,17,f,Sharon.jpg,pieFS2.bmp,Sharon is a single mother,2,na,560386,563276,2890,q,1
209662,27,5,2,18,20,m,Kevin.jpg,pieFS5.bmp,Kevin lost his life savings when his small business failed,2,na,575436,580157,4721,q,1
209662,28,3,5,11,16,m,Paul.jpg,pieFS3.bmp,Paul could not afford his mortgage and his home was foreclosed.,2,na,592317,594897,2580,q,1
209662,29,5,1,9,10,f,Eileen.jpg,pieFS5.bmp,Eileen takes discarded food from grocery stores to feed her children.,2,na,607067,611957,4890,q,1
209662,30,3,4,9,13,m,Jack.jpg,pieFS3.bmp,Jack cheated on his taxes and is now under investigation for tax fraud.,1,reputation,624132,628237,4105,p,0
209662,31,3,3,7,10,f,Maria.jpg,pieFS3.bmp,Maria steals her coworkers' tips to buy alcohol.,1,reputation,640397,642997,2600,p,0
209662,32,3,4,9,13,m,George.jpg,pieFS3.bmp,George is hiding his taxable income in Switzerland.,1,reputation,655147,658277,3130,p,0
209662,33,2,3,4,7,m,Matt.jpg,pieFS2.bmp,Matt is a veteran having trouble finding employment.,2,na,670430,673477,3047,q,1
209662,34,5,1,9,10,m,Taymar.jpg,pieFS5.bmp,Taymar underreports his company's earnings and pockets the profits.,1,reputation,685630,688978,3348,p,0
209662,35,3,2,4,6,f,Marny.jpg,pieFS3.bmp,Marny just lost her small business after a franchise moved in next door.,2,na,701146,704058,2912,q,1
209662,36,4,1,4,5,m,Alan.jpg,pieFS4.bmp,Alan is a well paid lawyer,1,resources,716229,721238,5009,p,0
209662,37,5,1,9,10,f,Emma.jpg,pieFS5.bmp,Emma just won the lottery,1,resources,733393,738038,4645,p,0
209662,38,4,4,16,20,f,Joanna.jpg,pieFS4.bmp,Joanna used her mother's social security number to open a credit card account.,1,reputation,750208,753078,2870,p,0
209662,39,3,3,7,10,m,Stuart.jpg,pieFS3.bmp,Stuart stole his elderly father's prescription medications.,1,reputation,765274,767859,2585,p,0
209662,40,5,1,9,10,f,Lauren.jpg,pieFS5.bmp,Lauren is raising money to buy gifts for children in need.,2,na,780058,783099,3041,q,1
209662,41,2,3,4,7,f,Kelly.jpg,pieFS2.bmp,Kelly illegally parks in the disabled parking spots when she can.,1,reputation,795257,798239,2982,q,1
209662,42,4,2,8,10,f,Kay.jpg,pieFS4.bmp,Kay cannot afford to send her son to college.,2,na,810407,810579,172,q,1
209662,43,3,2,4,6,f,Jackie.jpg,pieFS3.bmp,Jackie's car with her bag and credit cards was recently stolen.,2,na,822726,826239,3513,q,1
209662,44,4,4,16,20,m,Sam.jpg,pieFS4.bmp,Sam declared bankruptcy after he was laid off.,2,na,838426,840919,2493,p,0
209662,45,5,1,9,10,f,Mary.jpg,pieFS5.bmp,Mary regularly fires employees to avoid promoting them.,1,reputation,853109,855279,2170,p,0
209662,46,5,2,18,20,m,Darnell.jpg,pieFS5.bmp,Darnell takes valuables from his friends' homes when asked to house-sit.,1,reputation,867476,870720,3244,p,0
209662,47,4,4,16,20,f,Beth.jpg,pieFS4.bmp,Beth secretly gambles with her husband's savings.,1,reputation,882876,885000,2124,p,0
209662,48,5,2,18,20,f,Louise.jpg,pieFS5.bmp,Louise claims false expenses for her reportable work travel.,1,reputation,897160,899700,2540,p,0
209662,49,5,2,18,20,m,Michael.jpg,pieFS5.bmp,Michael was injured in a hit-and-run accident and cannot afford his medical bills.,2,na,911860,914340,2480,q,1
209662,50,5,1,9,10,f,Emily.jpg,pieFS5.bmp,Emily just found out that her husband has incurred a large credit card debt.,2,na,926510,930680,4170,q,1
209662,51,5,1,9,10,f,Sammy.jpg,pieFS5.bmp,Sammy is a highly paid actress,1,resources,942842,946140,3298,p,0
209662,52,4,1,4,5,f,Fiona.jpg,pieFS4.bmp,Fiona works as a cleaner in a hotel,2,na,958308,961121,2813,q,1
209847,1,5,1,9,10,f,Jenny.jpg,pieFS5.bmp,Jenny works two waitressing jobs to pay her bills.,2,na,54536,69125,14589,q,1
209847,2,3,4,9,13,m,George.jpg,pieFS3.bmp,George employs illegal immigrants and pays them less than minimum wage.,1,reputation,81323,84005,2682,q,1
209847,3,2,3,4,7,f,Joanna.jpg,pieFS2.bmp,Joanna just received a huge cash settlement,1,resources,96206,98386,2180,q,1
209847,4,4,2,8,10,f,Arianna.jpg,pieFS4.bmp,Arianna is a single mother,2,na,110574,113386,2812,q,1
209847,5,4,2,8,10,f,Jackie.jpg,pieFS4.bmp,Jackie takes discarded food from grocery stores to feed her children.,2,na,125574,127406,1832,q,1
209847,6,1,5,5,10,f,Monica.jpg,pieFS1.bmp,Monica steals her coworkers' tips to buy alcohol.,1,reputation,139575,142866,3291,p,0
209847,7,3,6,14,20,m,Nick.jpg,pieFS3.bmp,Nick lost his life savings when his small business failed,2,na,155041,157187,2146,q,1
209847,8,5,1,9,10,m,Joe.jpg,pieFS5.bmp,Joe could not afford his mortgage and his home was foreclosed.,2,na,169358,171247,1889,q,1
209847,9,3,3,7,10,f,Eileen.jpg,pieFS3.bmp,Eileen just lost her small business after a franchise moved in next door.,2,na,183426,185387,1961,q,1
209847,10,3,2,4,6,f,Emma.jpg,pieFS3.bmp,Emma just won the lottery,1,resources,197544,199668,2124,p,0
209847,11,2,6,9,15,m,Kevin.jpg,pieFS2.bmp,Kevin cheated on his taxes and is now under investigation for tax fraud.,1,reputation,211845,215968,4123,q,1
209847,12,5,2,18,20,m,Ben.jpg,pieFS5.bmp,Ben is a veteran having trouble finding employment.,2,na,228127,230028,1901,q,1
209847,13,3,5,11,16,f,Cindy.jpg,pieFS3.bmp,Cindy used her mother's social security number to open a credit card account.,1,reputation,242178,244848,2670,p,0
209847,14,3,4,9,13,m,Alan.jpg,pieFS3.bmp,Alan is hiding his taxable income in Switzerland.,1,reputation,256994,259189,2195,p,0
209847,15,2,7,10,17,f,Lauren.jpg,pieFS2.bmp,Lauren is raising money to buy gifts for children in need.,2,na,271345,273029,1684,q,1
209847,16,5,1,9,10,f,Jean.jpg,pieFS5.bmp,Jean illegally parks in the disabled parking spots when she can.,1,reputation,285180,288789,3609,p,0
209847,17,4,2,8,10,m,Darnell.jpg,pieFS4.bmp,Darnell stole his elderly father's prescription medications.,1,reputation,300946,303270,2324,p,0
209847,18,1,10,10,20,f,Kelly.jpg,pieFS1.bmp,Kelly's car with her bag and credit cards was recently stolen.,2,na,315430,324970,9540,q,1
209847,19,4,4,16,20,m,Mark.jpg,pieFS4.bmp,Mark declared bankruptcy after he was laid off.,2,na,337122,339530,2408,q,1
209847,20,4,3,12,15,f,Deborah.jpg,pieFS4.bmp,Deborah just found out that her husband has incurred a large credit card debt.,2,na,351723,354750,3027,q,1
209847,21,5,2,18,20,m,Paul.jpg,pieFS5.bmp,Paul underreports his company's earnings and pockets the profits.,1,reputation,366906,368931,2025,p,0
209847,22,3,3,7,10,m,Stuart.jpg,pieFS3.bmp,Stuart takes valuables from his friends' homes when asked to house-sit.,1,reputation,381090,382831,1741,p,0
209847,23,2,3,4,7,m,Brad.jpg,pieFS2.bmp,Brad was injured in a hit-and-run accident and cannot afford his medical bills.,2,na,395008,397551,2543,q,1
209847,24,3,2,4,6,f,Sharon.jpg,pieFS3.bmp,Sharon cannot afford to send her son to college.,2,na,409742,411432,1690,q,1
209847,25,5,2,18,20,f,Maria.jpg,pieFS5.bmp,Maria is a highly paid actress,1,resources,423593,430232,6639,p,0
209847,26,4,1,4,5,m,Justin.jpg,pieFS4.bmp,Justin is a well paid lawyer,1,resources,442389,444152,1763,p,0
209847,27,5,2,18,20,m,Peter.jpg,pieFS5.bmp,Peter was mugged and had his wallet stolen.,2,na,456307,458212,1905,q,1
209847,28,3,4,9,13,m,Ian.jpg,pieFS3.bmp,Ian often goes through and steals the neighbors' mail.,1,reputation,470358,472133,1775,p,0
209847,29,4,4,16,20,f,Fiona.jpg,pieFS4.bmp,Fiona regularly fires employees to avoid promoting them.,1,reputation,484292,485873,1581,p,0
209847,30,2,6,9,15,m,Daniel.jpg,pieFS2.bmp,Daniel is a retiree,2,na,498027,500373,2346,q,1
209847,31,4,3,12,15,m,Jack.jpg,pieFS4.bmp,Jack has been unable to find a job for over a year.,2,na,512528,514813,2285,p,0
209847,32,5,1,9,10,f,Janet.jpg,pieFS5.bmp,Janet secretly gambles with her husband's savings.,1,reputation,526962,528814,1852,p,0
209847,33,1,8,8,16,m,Tony.jpg,pieFS1.bmp,Tony lost his house in a fire,2,na,540963,545694,4731,p,0
209847,34,4,3,12,15,f,Louise.jpg,pieFS4.bmp,Louise claims false expenses for her reportable work travel.,1,reputation,557844,559854,2010,p,0
209847,35,3,2,4,6,f,Emily.jpg,pieFS3.bmp,Emily has to take an unpaid leave of absence because her mother broke her hip.,2,na,572028,575015,2987,q,1
209847,36,5,2,18,20,m,Jared.jpg,pieFS5.bmp,Jared just bought an expensive sports car,1,resources,587178,589195,2017,p,0
209847,37,5,1,9,10,f,Fay.jpg,pieFS5.bmp,Fay works as a cleaner in a hotel,2,na,601362,603375,2013,q,1
209847,38,5,1,9,10,f,Beth.jpg,pieFS5.bmp,Beth's husband is a wealthy investment banker,1,resources,615563,617615,2052,p,0
209847,39,3,3,7,10,f,Marny.jpg,pieFS3.bmp,Marny got a large cash bonus from her boss,1,resources,629764,631776,2012,q,1
209847,40,3,6,14,20,m,Edward.jpg,pieFS3.bmp,Edward is saving for his son's operation,2,na,643932,645516,1584,q,1
209847,41,1,9,9,18,m,Saul.jpg,pieFS1.bmp,Saul just found $50 on the street,1,resources,657683,659776,2093,q,1
209847,42,4,1,4,5,m,Matt.jpg,pieFS4.bmp,Matt is homeless,2,na,671934,673596,1662,q,1
209847,43,4,2,8,10,m,Ricky.jpg,pieFS4.bmp,Ricky bullies his employees to put in extra hours at work.,1,reputation,685769,688017,2248,p,0
209847,44,5,1,9,10,f,Sammy.jpg,pieFS5.bmp,Sammy was a victim of identity theft and is now thousands of dollars in debt.,2,na,700169,701917,1748,q,1
209847,45,3,5,11,16,m,Sam.jpg,pieFS3.bmp,Sam is saving to pay his university fees,2,na,714071,715757,1686,q,1
209847,46,5,1,9,10,m,Michael.jpg,pieFS5.bmp,Michael lives in a luxury penthouse apartment,1,resources,727905,729537,1632,q,1
209847,47,4,1,4,5,f,Kay.jpg,pieFS4.bmp,Kay can't afford to pay her medical bills,2,na,741690,743158,1468,q,1
209847,48,5,1,9,10,m,Taymar.jpg,pieFS5.bmp,Taymar just lost his job,2,na,755308,756738,1430,q,1
209847,49,3,2,4,6,f,Miriam.jpg,pieFS3.bmp,Miriam is going to be evicted because she is behind on her rent,2,na,768893,770658,1765,q,1
209847,50,4,4,16,20,f,Trish.jpg,pieFS4.bmp,Trish owns an international company,1,resources,782811,784858,2047,p,0
209847,51,4,3,12,15,m,Don.jpg,pieFS4.bmp,Don stole money from his mother's wallet.,1,reputation,797012,798979,1967,p,0
209847,52,2,8,12,20,f,Mary.jpg,pieFS2.bmp,Mary received a large inheritance from a distant relative,1,resources,811129,814699,3570,q,1
210079,1,4,3,12,15,m,Jared.jpg,pieFS4.bmp,Jared is hiding his taxable income in Switzerland.,1,reputation,57283,61839,4556,q,1
210079,2,4,1,4,5,m,Tony.jpg,pieFS4.bmp,Tony often goes through and steals the neighbors' mail.,1,reputation,74031,75739,1708,p,0
210079,3,5,2,18,20,m,George.jpg,pieFS5.bmp,George underreports his company's earnings and pockets the profits.,1,reputation,87932,89499,1567,p,0
210079,4,2,7,10,17,f,Sammy.jpg,pieFS2.bmp,Sammy's car with her bag and credit cards was recently stolen.,2,na,101683,103859,2176,p,0
210079,5,3,2,4,6,f,Kelly.jpg,pieFS3.bmp,Kelly just found out that her husband has incurred a large credit card debt.,2,na,116033,117659,1626,p,0
210079,6,5,2,18,20,f,Kay.jpg,pieFS5.bmp,Kay secretly gambles with her husband's savings.,1,reputation,129834,130319,485,p,0
210079,7,5,1,9,10,f,Jean.jpg,pieFS5.bmp,Jean is a highly paid actress,1,resources,142470,146500,4030,q,1
210079,8,5,1,9,10,f,Miriam.jpg,pieFS5.bmp,Miriam claims false expenses for her reportable work travel.,1,reputation,158669,160340,1671,p,0
210079,9,1,8,8,16,m,Mark.jpg,pieFS1.bmp,Mark has been unable to find a job for over a year.,2,na,172520,174120,1600,p,0
210079,10,2,6,9,15,m,Ben.jpg,pieFS2.bmp,Ben lost his house in a fire,2,na,186271,188720,2449,p,0
210079,11,5,2,18,20,m,Sam.jpg,pieFS5.bmp,Sam just found $50 on the street,1,resources,200871,204460,3589,p,0
210079,12,3,3,7,10,f,Sharon.jpg,pieFS3.bmp,Sharon works as a cleaner in a hotel,2,na,216620,218580,1960,p,0
210079,13,3,2,4,6,f,Jenny.jpg,pieFS3.bmp,Jenny has to take an unpaid leave of absence because her mother broke her hip.,2,na,230738,232760,2022,p,0
210079,14,1,5,5,10,f,Maria.jpg,pieFS1.bmp,Maria got a large cash bonus from her boss,1,resources,244922,247360,2438,q,1
210079,15,4,1,4,5,m,Kevin.jpg,pieFS4.bmp,Kevin is homeless,2,na,259522,260880,1358,p,0
210079,16,5,1,9,10,m,Ricky.jpg,pieFS5.bmp,Ricky is a well paid lawyer,1,resources,273040,276400,3360,q,1
210079,17,4,1,4,5,f,Eileen.jpg,pieFS4.bmp,Eileen was a victim of identity theft and is now thousands of dollars in debt.,2,na,288573,290640,2067,p,0
210079,18,2,3,4,7,f,Janet.jpg,pieFS2.bmp,Janet's husband is a wealthy investment banker,1,resources,302790,307780,4990,q,1
210079,19,3,5,11,16,m,Matt.jpg,pieFS3.bmp,Matt is saving to pay his university fees,2,na,319937,321920,1983,p,0
210079,20,5,1,9,10,f,Trish.jpg,pieFS5.bmp,Trish can't afford to pay her medical bills,2,na,334071,335140,1069,p,0
210079,21,3,3,7,10,m,Brad.jpg,pieFS3.bmp,Brad lives in a luxury penthouse apartment,1,resources,347290,353080,5790,q,1
210079,22,4,4,16,20,m,Taymar.jpg,pieFS4.bmp,Taymar is a retiree,2,na,365236,366660,1424,p,0
210079,23,5,1,9,10,f,Jackie.jpg,pieFS5.bmp,Jackie works two waitressing jobs to pay her bills.,2,na,378821,379820,999,p,0
210079,24,3,5,11,16,f,Deborah.jpg,pieFS3.bmp,Deborah just received a huge cash settlement,1,resources,391973,399720,7747,p,0
210079,25,4,2,8,10,m,Nick.jpg,pieFS4.bmp,Nick stole money from his mother's wallet.,1,reputation,411867,413560,1693,p,0
210079,26,2,3,4,7,m,Stuart.jpg,pieFS2.bmp,Stuart lost his life savings when his small business failed,2,na,425718,427561,1843,p,0
210079,27,4,2,8,10,m,Peter.jpg,pieFS4.bmp,Peter cheated on his taxes and is now under investigation for tax fraud.,1,reputation,439736,440881,1145,p,0
210079,28,4,2,8,10,f,Lauren.jpg,pieFS4.bmp,Lauren takes discarded food from grocery stores to feed her children.,2,na,453038,454221,1183,p,0
210079,29,3,4,9,13,m,Alan.jpg,pieFS3.bmp,Alan just bought an expensive sports car,1,resources,466373,469081,2708,q,1
210079,30,4,4,16,20,f,Joanna.jpg,pieFS4.bmp,Joanna steals her coworkers' tips to buy alcohol.,1,reputation,481239,482501,1262,p,0
210079,31,5,2,18,20,m,Saul.jpg,pieFS5.bmp,Saul is a veteran having trouble finding employment.,2,na,494658,496341,1683,p,0
210079,32,2,6,9,15,m,Darnell.jpg,pieFS2.bmp,Darnell stole his elderly father's prescription medications.,1,reputation,508492,510301,1809,p,0
210079,33,4,3,12,15,m,Justin.jpg,pieFS4.bmp,Justin is saving for his son's operation,2,na,522460,525201,2741,p,0
210079,34,1,9,9,18,m,Paul.jpg,pieFS1.bmp,Paul bullies his employees to put in extra hours at work.,1,reputation,537360,546081,8721,q,1
210079,35,5,1,9,10,f,Mary.jpg,pieFS5.bmp,Mary is going to be evicted because she is behind on her rent,2,na,558236,566961,8725,p,0
210079,36,5,1,9,10,m,Don.jpg,pieFS5.bmp,Don declared bankruptcy after he was laid off.,2,na,579113,583901,4788,p,0
210079,37,3,4,9,13,m,Jack.jpg,pieFS3.bmp,Jack takes valuables from his friends' homes when asked to house-sit.,1,reputation,596060,599261,3201,p,0
210079,38,5,1,9,10,m,Edward.jpg,pieFS5.bmp,Edward just lost his job,2,na,611410,614781,3371,q,1
210079,39,3,2,4,6,f,Emily.jpg,pieFS3.bmp,Emily just lost her small business after a franchise moved in next door.,2,na,626942,628361,1419,p,0
210079,40,2,8,12,20,f,Fiona.jpg,pieFS2.bmp,Fiona owns an international company,1,resources,640510,644081,3571,q,1
210079,41,3,3,7,10,f,Emma.jpg,pieFS3.bmp,Emma received a large inheritance from a distant relative,1,resources,656243,658181,1938,q,1
210079,42,3,4,9,13,m,Daniel.jpg,pieFS3.bmp,Daniel employs illegal immigrants and pays them less than minimum wage.,1,reputation,670360,672781,2421,p,0
210079,43,4,2,8,10,f,Beth.jpg,pieFS4.bmp,Beth is a single mother,2,na,684944,690281,5337,q,1
210079,44,3,6,14,20,m,Joe.jpg,pieFS3.bmp,Joe could not afford his mortgage and his home was foreclosed.,2,na,702441,705342,2901,p,0
210079,45,4,4,16,20,f,Louise.jpg,pieFS4.bmp,Louise just won the lottery,1,resources,717490,719361,1871,q,1
210079,46,4,3,12,15,f,Monica.jpg,pieFS4.bmp,Monica used her mother's social security number to open a credit card account.,1,reputation,731525,734442,2917,p,0
210079,47,5,2,18,20,m,Ian.jpg,pieFS5.bmp,Ian was injured in a hit-and-run accident and cannot afford his medical bills.,2,na,746608,748262,1654,p,0
210079,48,3,6,14,20,m,Michael.jpg,pieFS3.bmp,Michael was mugged and had his wallet stolen.,2,na,760409,763082,2673,p,0
210079,49,4,3,12,15,f,Marny.jpg,pieFS4.bmp,Marny is raising money to buy gifts for children in need.,2,na,775242,780142,4900,p,0
210079,50,3,2,4,6,f,Cindy.jpg,pieFS3.bmp,Cindy illegally parks in the disabled parking spots when she can.,1,reputation,792306,797262,4956,q,1
210079,51,1,10,10,20,f,Arianna.jpg,pieFS1.bmp,Arianna cannot afford to send her son to college.,2,na,809420,812082,2662,p,0
210079,52,5,1,9,10,f,Fay.jpg,pieFS5.bmp,Fay regularly fires employees to avoid promoting them.,1,reputation,824237,827522,3285,q,1
210100,1,5,1,9,10,m,Paul.jpg,pieFS5.bmp,Paul underreports his company's earnings and pockets the profits.,1,reputation,32518,37926,5408,p,0
210100,2,3,3,7,10,f,Cindy.jpg,pieFS3.bmp,Cindy just received a huge cash settlement,1,resources,50125,53132,3007,q,1
210100,3,1,10,10,20,f,Jenny.jpg,pieFS1.bmp,Jenny takes discarded food from grocery stores to feed her children.,2,na,65291,70568,5277,q,1
210100,4,4,1,4,5,m,Nick.jpg,pieFS4.bmp,Nick is saving to pay his university fees,2,na,82748,87100,4352,q,1
210100,5,2,3,4,7,f,Jackie.jpg,pieFS2.bmp,Jackie steals her coworkers' tips to buy alcohol.,1,reputation,99301,102592,3291,p,0
210100,6,4,2,8,10,m,Don.jpg,pieFS4.bmp,Don lives in a luxury penthouse apartment,1,resources,114785,118267,3482,q,1
210100,7,1,9,9,18,m,Edward.jpg,pieFS1.bmp,Edward is a well paid lawyer,1,resources,130469,133603,3134,q,1
210100,8,4,1,4,5,f,Emily.jpg,pieFS4.bmp,Emily just lost her small business after a franchise moved in next door.,2,na,145785,149935,4150,p,0
210100,9,4,2,8,10,m,Darnell.jpg,pieFS4.bmp,Darnell stole money from his mother's wallet.,1,reputation,162138,166509,4371,p,0
210100,10,5,1,9,10,m,Justin.jpg,pieFS5.bmp,Justin is a retiree,2,na,178709,181921,3212,p,0
210100,11,4,3,12,15,f,Arianna.jpg,pieFS4.bmp,Arianna just won the lottery,1,resources,194109,196882,2773,q,1
210100,12,3,6,14,20,m,Ben.jpg,pieFS3.bmp,Ben lost his life savings when his small business failed,2,na,209074,213494,4420,q,1
210100,13,4,1,4,5,m,Ricky.jpg,pieFS4.bmp,Ricky just bought an expensive sports car,1,resources,225678,229282,3604,q,1
210100,14,5,1,9,10,f,Janet.jpg,pieFS5.bmp,Janet cannot afford to send her son to college.,2,na,241462,245406,3944,q,1
210100,15,3,4,9,13,m,Jack.jpg,pieFS3.bmp,Jack cheated on his taxes and is now under investigation for tax fraud.,1,reputation,257598,261450,3852,p,0
210100,16,2,3,4,7,m,Jared.jpg,pieFS2.bmp,Jared is saving for his son's operation,2,na,273633,276998,3365,q,1
210100,17,5,2,18,20,m,Saul.jpg,pieFS5.bmp,Saul is a veteran having trouble finding employment.,2,na,289150,292429,3279,q,1
210100,18,3,3,7,10,m,Mark.jpg,pieFS3.bmp,Mark stole his elderly father's prescription medications.,1,reputation,304634,308161,3527,p,0
210100,19,5,1,9,10,m,Michael.jpg,pieFS5.bmp,Michael declared bankruptcy after he was laid off.,2,na,320351,323548,3197,q,1
210100,20,4,4,16,20,f,Mary.jpg,pieFS4.bmp,Mary regularly fires employees to avoid promoting them.,1,reputation,335718,339359,3641,p,0
210100,21,5,2,18,20,m,Sam.jpg,pieFS5.bmp,Sam takes valuables from his friends' homes when asked to house-sit.,1,reputation,351553,354789,3236,p,0
210100,22,3,6,14,20,m,Stuart.jpg,pieFS3.bmp,Stuart was injured in a hit-and-run accident and cannot afford his medical bills.,2,na,366969,369676,2707,q,1
210100,23,3,5,11,16,f,Beth.jpg,pieFS3.bmp,Beth secretly gambles with her husband's savings.,1,reputation,381851,384202,2351,p,0
210100,24,1,8,8,16,m,Tony.jpg,pieFS1.bmp,Tony was mugged and had his wallet stolen.,2,na,396398,400369,3971,q,1
210100,25,3,4,9,13,m,Joe.jpg,pieFS3.bmp,Joe bullies his employees to put in extra hours at work.,1,reputation,412550,416774,4224,q,1
210100,26,5,1,9,10,f,Miriam.jpg,pieFS5.bmp,Miriam claims false expenses for her reportable work travel.,1,reputation,428970,432261,3291,p,0
210100,27,2,6,9,15,m,Kevin.jpg,pieFS2.bmp,Kevin often goes through and steals the neighbors' mail.,1,reputation,444437,448686,4249,p,0
210100,28,3,2,4,6,f,Trish.jpg,pieFS3.bmp,Trish works as a cleaner in a hotel,2,na,460890,463461,2571,q,1
210100,29,3,2,4,6,f,Deborah.jpg,pieFS3.bmp,Deborah used her mother's social security number to open a credit card account.,1,reputation,475655,479472,3817,p,0
210100,30,4,4,16,20,f,Kay.jpg,pieFS4.bmp,Kay's husband is a wealthy investment banker,1,resources,491640,494209,2569,q,1
210100,31,5,1,9,10,f,Marny.jpg,pieFS5.bmp,Marny is raising money to buy gifts for children in need.,2,na,506405,509208,2803,q,1
210100,32,3,5,11,16,m,Matt.jpg,pieFS3.bmp,Matt has been unable to find a job for over a year.,2,na,521420,524152,2732,q,1
210100,33,4,4,16,20,m,Peter.jpg,pieFS4.bmp,Peter lost his house in a fire,2,na,536352,539058,2706,q,1
210100,34,2,6,9,15,m,George.jpg,pieFS2.bmp,George just lost his job,2,na,551250,552667,1417,q,1
210100,35,2,8,12,20,f,Kelly.jpg,pieFS2.bmp,Kelly illegally parks in the disabled parking spots when she can.,1,reputation,564844,568489,3645,p,0
210100,36,3,2,4,6,f,Sharon.jpg,pieFS3.bmp,Sharon can't afford to pay her medical bills,2,na,580679,583812,3133,q,1
210100,37,3,4,9,13,m,Alan.jpg,pieFS3.bmp,Alan employs illegal immigrants and pays them less than minimum wage.,1,reputation,596012,598718,2706,p,0
210100,38,5,2,18,20,m,Taymar.jpg,pieFS5.bmp,Taymar could not afford his mortgage and his home was foreclosed.,2,na,610910,613924,3014,q,1
210100,39,4,2,8,10,f,Lauren.jpg,pieFS4.bmp,Lauren's car with her bag and credit cards was recently stolen.,2,na,626109,629725,3616,q,1
210100,40,3,3,7,10,f,Sammy.jpg,pieFS3.bmp,Sammy just found out that her husband has incurred a large credit card debt.,2,na,641911,644879,2968,q,1
210100,41,4,3,12,15,m,Ian.jpg,pieFS4.bmp,Ian just found $50 on the street,1,resources,657060,662072,5012,q,1
210100,42,4,3,12,15,m,Brad.jpg,pieFS4.bmp,Brad is homeless,2,na,674232,677897,3665,q,1
210100,43,5,2,18,20,f,Jean.jpg,pieFS5.bmp,Jean is a highly paid actress,1,resources,690100,692802,2702,q,1
210100,44,5,1,9,10,f,Emma.jpg,pieFS5.bmp,Emma is going to be evicted because she is behind on her rent,2,na,704998,708345,3347,q,1
210100,45,4,2,8,10,f,Maria.jpg,pieFS4.bmp,Maria has to take an unpaid leave of absence because her mother broke her hip.,2,na,720549,724132,3583,q,1
210100,46,5,1,9,10,f,Fiona.jpg,pieFS5.bmp,Fiona owns an international company,1,resources,736300,738564,2264,q,1
210100,47,1,5,5,10,f,Fay.jpg,pieFS1.bmp,Fay received a large inheritance from a distant relative,1,resources,750747,753625,2878,q,1
210100,48,5,1,9,10,f,Joanna.jpg,pieFS5.bmp,Joanna got a large cash bonus from her boss,1,resources,765829,768193,2364,q,1
210100,49,5,2,18,20,m,Daniel.jpg,pieFS5.bmp,Daniel is hiding his taxable income in Switzerland.,1,reputation,780376,788630,8254,p,0
210100,50,3,2,4,6,f,Eileen.jpg,pieFS3.bmp,Eileen was a victim of identity theft and is now thousands of dollars in debt.,2,na,800843,802968,2125,q,1
210100,51,4,3,12,15,f,Monica.jpg,pieFS4.bmp,Monica works two waitressing jobs to pay her bills.,2,na,815122,817635,2513,q,1
210100,52,2,7,10,17,f,Louise.jpg,pieFS2.bmp,Louise is a single mother,2,na,829837,832522,2685,q,1
210290,1,4,2,8,10,f,Kelly.jpg,pieFS4.bmp,Kelly just found out that her husband has incurred a large credit card debt.,2,na,70573,76477,5904,p,0
210290,2,4,4,16,20,f,Maria.jpg,pieFS4.bmp,Maria is a highly paid actress,1,resources,88670,92857,4187,p,0
210290,3,5,2,18,20,m,Alan.jpg,pieFS5.bmp,Alan underreports his company's earnings and pockets the profits.,1,reputation,105051,108277,3226,p,0
210290,4,4,2,8,10,m,Justin.jpg,pieFS4.bmp,Justin is a well paid lawyer,1,resources,120467,123657,3190,p,0
210290,5,4,4,16,20,f,Kay.jpg,pieFS4.bmp,Kay received a large inheritance from a distant relative,1,resources,135850,138337,2487,p,0
210290,6,4,1,4,5,m,Daniel.jpg,pieFS4.bmp,Daniel is a retiree,2,na,150533,159257,8724,p,0
210290,7,4,3,12,15,m,Paul.jpg,pieFS4.bmp,Paul just bought an expensive sports car,1,resources,171460,173517,2057,p,0
210290,8,4,1,4,5,m,Kevin.jpg,pieFS4.bmp,Kevin just found $50 on the street,1,resources,185711,189597,3886,p,0
210290,9,3,2,4,6,f,Sammy.jpg,pieFS3.bmp,Sammy has to take an unpaid leave of absence because her mother broke her hip.,2,na,201792,204518,2726,q,1
210290,10,4,3,12,15,f,Janet.jpg,pieFS4.bmp,Janet is a single mother,2,na,216709,221298,4589,q,1
210290,11,5,2,18,20,m,Taymar.jpg,pieFS5.bmp,Taymar is saving for his son's operation,2,na,233490,235338,1848,q,1
210290,12,1,5,5,10,f,Lauren.jpg,pieFS1.bmp,Lauren got a large cash bonus from her boss,1,resources,247524,251878,4354,q,1
210290,13,5,1,9,10,f,Miriam.jpg,pieFS5.bmp,Miriam just won the lottery,1,resources,264056,266518,2462,p,0
210290,14,4,3,12,15,m,Nick.jpg,pieFS4.bmp,Nick is homeless,2,na,278706,281198,2492,q,1
210290,15,5,1,9,10,f,Deborah.jpg,pieFS5.bmp,Deborah was a victim of identity theft and is now thousands of dollars in debt.,2,na,293390,296258,2868,q,1
210290,16,5,1,9,10,f,Cindy.jpg,pieFS5.bmp,Cindy works two waitressing jobs to pay her bills.,2,na,308456,310838,2382,q,1
210290,17,3,6,14,20,m,Mark.jpg,pieFS3.bmp,Mark is saving to pay his university fees,2,na,323023,327498,4475,q,1
210290,18,4,3,12,15,f,Jackie.jpg,pieFS4.bmp,Jackie just received a huge cash settlement,1,resources,339687,342158,2471,p,0
210290,19,3,4,9,13,m,Don.jpg,pieFS3.bmp,Don lives in a luxury penthouse apartment,1,resources,354354,357818,3464,p,0
210290,20,4,2,8,10,m,Edward.jpg,pieFS4.bmp,Edward bullies his employees to put in extra hours at work.,1,reputation,370020,374058,4038,p,0
210290,21,5,1,9,10,m,Joe.jpg,pieFS5.bmp,Joe just lost his job,2,na,386252,389758,3506,q,1
210290,22,5,1,9,10,f,Emily.jpg,pieFS5.bmp,Emily takes discarded food from grocery stores to feed her children.,2,na,401951,404818,2867,q,1
210290,23,2,7,10,17,f,Beth.jpg,pieFS2.bmp,Beth cannot afford to send her son to college.,2,na,416984,419098,2114,q,1
210290,24,5,1,9,10,m,George.jpg,pieFS5.bmp,George employs illegal immigrants and pays them less than minimum wage.,1,reputation,431251,434838,3587,p,0
210290,25,3,3,7,10,m,Michael.jpg,pieFS3.bmp,Michael stole money from his mother's wallet.,1,reputation,447000,450058,3058,p,0
210290,26,5,1,9,10,f,Jenny.jpg,pieFS5.bmp,Jenny steals her coworkers' tips to buy alcohol.,1,reputation,462216,464258,2042,p,0
210290,27,3,3,7,10,f,Emma.jpg,pieFS3.bmp,Emma regularly fires employees to avoid promoting them.,1,reputation,476417,479459,3042,p,0
210290,28,1,8,8,16,m,Ian.jpg,pieFS1.bmp,Ian lost his life savings when his small business failed,2,na,491617,494178,2561,q,1
210290,29,1,9,9,18,m,Peter.jpg,pieFS1.bmp,Peter cheated on his taxes and is now under investigation for tax fraud.,1,reputation,506350,506638,288,p,0
210290,30,3,5,11,16,m,Ricky.jpg,pieFS3.bmp,Ricky could not afford his mortgage and his home was foreclosed.,2,na,518803,521139,2336,q,1
210290,31,3,3,7,10,f,Joanna.jpg,pieFS3.bmp,Joanna just lost her small business after a franchise moved in next door.,2,na,533286,535239,1953,q,1
210290,32,5,2,18,20,f,Trish.jpg,pieFS5.bmp,Trish secretly gambles with her husband's savings.,1,reputation,547387,550299,2912,p,0
210290,33,2,6,9,15,m,Saul.jpg,pieFS2.bmp,Saul is a veteran having trouble finding employment.,2,na,562454,564839,2385,q,1
210290,34,2,6,9,15,m,Darnell.jpg,pieFS2.bmp,Darnell stole his elderly father's prescription medications.,1,reputation,576987,579639,2652,p,0
210290,35,3,2,4,6,f,Fiona.jpg,pieFS3.bmp,Fiona claims false expenses for her reportable work travel.,1,reputation,591787,594499,2712,p,0
210290,36,5,1,9,10,m,Brad.jpg,pieFS5.bmp,Brad declared bankruptcy after he was laid off.,2,na,606654,609299,2645,q,1
210290,37,3,4,9,13,m,Tony.jpg,pieFS3.bmp,Tony takes valuables from his friends' homes when asked to house-sit.,1,reputation,621471,623739,2268,p,0
210290,38,3,5,11,16,f,Eileen.jpg,pieFS3.bmp,Eileen used her mother's social security number to open a credit card account.,1,reputation,635904,637979,2075,p,0
210290,39,3,2,4,6,f,Marny.jpg,pieFS3.bmp,Marny is raising money to buy gifts for children in need.,2,na,650155,652519,2364,q,1
210290,40,2,3,4,7,m,Jack.jpg,pieFS2.bmp,Jack was injured in a hit-and-run accident and cannot afford his medical bills.,2,na,664689,666779,2090,q,1
210290,41,4,4,16,20,m,Ben.jpg,pieFS4.bmp,Ben was mugged and had his wallet stolen.,2,na,679006,681519,2513,q,1
210290,42,4,2,8,10,f,Louise.jpg,pieFS4.bmp,Louise works as a cleaner in a hotel,2,na,693756,695879,2123,q,1
210290,43,2,8,12,20,f,Mary.jpg,pieFS2.bmp,Mary's husband is a wealthy investment banker,1,resources,708090,711239,3149,p,0
210290,44,5,2,18,20,m,Sam.jpg,pieFS5.bmp,Sam often goes through and steals the neighbors' mail.,1,reputation,723456,726580,3124,p,0
210290,45,4,1,4,5,f,Fay.jpg,pieFS4.bmp,Fay can't afford to pay her medical bills,2,na,738789,740740,1951,q,1
210290,46,5,2,18,20,m,Stuart.jpg,pieFS5.bmp,Stuart has been unable to find a job for over a year.,2,na,752956,755520,2564,q,1
210290,47,5,1,9,10,f,Jean.jpg,pieFS5.bmp,Jean illegally parks in the disabled parking spots when she can.,1,reputation,767756,770500,2744,p,0
210290,48,3,2,4,6,f,Monica.jpg,pieFS3.bmp,Monica's car with her bag and credit cards was recently stolen.,2,na,782756,785480,2724,q,1
210290,49,3,4,9,13,m,Jared.jpg,pieFS3.bmp,Jared is hiding his taxable income in Switzerland.,1,reputation,797756,800400,2644,p,0
210290,50,3,6,14,20,m,Matt.jpg,pieFS3.bmp,Matt lost his house in a fire,2,na,812656,814840,2184,q,1
210290,51,1,10,10,20,f,Arianna.jpg,pieFS1.bmp,Arianna is going to be evicted because she is behind on her rent,2,na,827073,829400,2327,q,1
210290,52,2,3,4,7,f,Sharon.jpg,pieFS2.bmp,Sharon owns an international company,1,resources,841656,845440,3784,p,0
210374,1,4,2,8,10,m,Michael.jpg,pieFS4.bmp,Michael stole money from his mother's wallet.,1,reputation,50834,60829,9995,p,0
210374,2,4,3,12,15,m,Paul.jpg,pieFS4.bmp,Paul is saving for his son's operation,2,na,73026,76690,3664,p,0
210374,3,2,6,9,15,m,Brad.jpg,pieFS2.bmp,Brad lost his life savings when his small business failed,2,na,88875,96050,7175,q,1
210374,4,4,1,4,5,f,Jean.jpg,pieFS4.bmp,Jean just found out that her husband has incurred a large credit card debt.,2,na,108237,118510,10273,q,1
210374,5,5,1,9,10,f,Beth.jpg,pieFS5.bmp,Beth received a large inheritance from a distant relative,1,resources,130679,135311,4632,q,1
210374,6,4,4,16,20,f,Monica.jpg,pieFS4.bmp,Monica is a highly paid actress,1,resources,147477,151011,3534,q,1
210374,7,4,2,8,10,f,Marny.jpg,pieFS4.bmp,Marny has to take an unpaid leave of absence because her mother broke her hip.,2,na,163176,167091,3915,q,1
210374,8,2,7,10,17,f,Louise.jpg,pieFS2.bmp,Louise is a single mother,2,na,179241,185372,6131,q,1
210374,9,3,4,9,13,m,Alan.jpg,pieFS3.bmp,Alan bullies his employees to put in extra hours at work.,1,reputation,197588,205072,7484,p,0
210374,10,4,3,12,15,f,Cindy.jpg,pieFS4.bmp,Cindy got a large cash bonus from her boss,1,resources,217299,220773,3474,q,1
210374,11,3,4,9,13,m,Kevin.jpg,pieFS3.bmp,Kevin cheated on his taxes and is now under investigation for tax fraud.,1,reputation,232982,246573,13591,p,0
210374,12,5,1,9,10,f,Jenny.jpg,pieFS5.bmp,Jenny was a victim of identity theft and is now thousands of dollars in debt.,2,na,258803,263593,4790,q,1
210374,13,3,6,14,20,m,Tony.jpg,pieFS3.bmp,Tony is a veteran having trouble finding employment.,2,na,275801,278054,2253,q,1
210374,14,5,1,9,10,f,Arianna.jpg,pieFS5.bmp,Arianna just won the lottery,1,resources,290285,291794,1509,q,1
210374,15,3,2,4,6,f,Emma.jpg,pieFS3.bmp,Emma cannot afford to send her son to college.,2,na,304003,307614,3611,q,1
210374,16,4,2,8,10,m,Stuart.jpg,pieFS4.bmp,Stuart stole his elderly father's prescription medications.,1,reputation,319835,324234,4399,p,0
210374,17,3,5,11,16,m,Edward.jpg,pieFS3.bmp,Edward just lost his job,2,na,336467,340195,3728,q,1
210374,18,5,2,18,20,m,Jack.jpg,pieFS5.bmp,Jack declared bankruptcy after he was laid off.,2,na,352416,356715,4299,q,1
210374,19,2,6,9,15,m,Don.jpg,pieFS2.bmp,Don takes valuables from his friends' homes when asked to house-sit.,1,reputation,368931,371595,2664,p,0
210374,20,3,5,11,16,f,Trish.jpg,pieFS3.bmp,Trish regularly fires employees to avoid promoting them.,1,reputation,383881,389636,5755,p,0
210374,21,4,4,16,20,m,Nick.jpg,pieFS4.bmp,Nick was injured in a hit-and-run accident and cannot afford his medical bills.,2,na,401894,405216,3322,q,1
210374,22,4,3,12,15,f,Eileen.jpg,pieFS4.bmp,Eileen works two waitressing jobs to pay her bills.,2,na,417444,419756,2312,q,1
210374,23,5,1,9,10,m,Ian.jpg,pieFS5.bmp,Ian was mugged and had his wallet stolen.,2,na,431961,433436,1475,q,1
210374,24,3,2,4,6,f,Emily.jpg,pieFS3.bmp,Emily just received a huge cash settlement,1,resources,445646,446877,1231,q,1
210374,25,1,5,5,10,f,Kay.jpg,pieFS1.bmp,Kay secretly gambles with her husband's savings.,1,reputation,459097,469757,10660,p,0
210374,26,5,1,9,10,m,Joe.jpg,pieFS5.bmp,Joe employs illegal immigrants and pays them less than minimum wage.,1,reputation,481972,483318,1346,p,0
210374,27,4,1,4,5,m,Daniel.jpg,pieFS4.bmp,Daniel could not afford his mortgage and his home was foreclosed.,2,na,495524,497658,2134,q,1
210374,28,1,9,9,18,m,Justin.jpg,pieFS1.bmp,Justin is hiding his taxable income in Switzerland.,1,reputation,509874,516098,6224,p,0
210374,29,5,2,18,20,m,Sam.jpg,pieFS5.bmp,Sam often goes through and steals the neighbors' mail.,1,reputation,528321,532278,3957,p,0
210374,30,5,2,18,20,m,Jared.jpg,pieFS5.bmp,Jared underreports his company's earnings and pockets the profits.,1,reputation,544503,546059,1556,p,0
210374,31,1,8,8,16,m,Darnell.jpg,pieFS1.bmp,Darnell has been unable to find a job for over a year.,2,na,558287,569899,11612,q,1
210374,32,2,8,12,20,f,Sharon.jpg,pieFS2.bmp,Sharon claims false expenses for her reportable work travel.,1,reputation,582128,584919,2791,p,0
210374,33,4,2,8,10,f,Kelly.jpg,pieFS4.bmp,Kelly takes discarded food from grocery stores to feed her children.,2,na,597078,599199,2121,q,1
210374,34,3,6,14,20,m,Saul.jpg,pieFS3.bmp,Saul lost his house in a fire,2,na,611345,613740,2395,q,1
210374,35,3,3,7,10,f,Miriam.jpg,pieFS3.bmp,Miriam works as a cleaner in a hotel,2,na,625896,627220,1324,q,1
210374,36,3,4,9,13,m,Matt.jpg,pieFS3.bmp,Matt just found $50 on the street,1,resources,639397,642940,3543,q,1
210374,37,5,2,18,20,f,Jackie.jpg,pieFS5.bmp,Jackie steals her coworkers' tips to buy alcohol.,1,reputation,655097,657841,2744,p,0
210374,38,2,3,4,7,m,Mark.jpg,pieFS2.bmp,Mark is homeless,2,na,669997,673261,3264,q,1
210374,39,2,3,4,7,f,Fay.jpg,pieFS2.bmp,Fay's husband is a wealthy investment banker,1,resources,685413,687981,2568,q,1
210374,40,4,1,4,5,m,George.jpg,pieFS4.bmp,George is a well paid lawyer,1,resources,700130,703341,3211,q,1
210374,41,5,1,9,10,f,Joanna.jpg,pieFS5.bmp,Joanna just lost her small business after a franchise moved in next door.,2,na,715496,718682,3186,q,1
210374,42,5,2,18,20,m,Peter.jpg,pieFS5.bmp,Peter is saving to pay his university fees,2,na,730829,734102,3273,q,1
210374,43,4,3,12,15,m,Ben.jpg,pieFS4.bmp,Ben lives in a luxury penthouse apartment,1,resources,746262,748342,2080,q,1
210374,44,5,1,9,10,m,Taymar.jpg,pieFS5.bmp,Taymar is a retiree,2,na,760496,763143,2647,q,1
210374,45,3,3,7,10,f,Sammy.jpg,pieFS3.bmp,Sammy used her mother's social security number to open a credit card account.,1,reputation,775297,778463,3166,p,0
210374,46,5,1,9,10,f,Mary.jpg,pieFS5.bmp,Mary can't afford to pay her medical bills,2,na,790613,792743,2130,q,1
210374,47,3,2,4,6,f,Maria.jpg,pieFS3.bmp,Maria is raising money to buy gifts for children in need.,2,na,804914,806983,2069,q,1
210374,48,5,1,9,10,f,Deborah.jpg,pieFS5.bmp,Deborah illegally parks in the disabled parking spots when she can.,1,reputation,819148,826624,7476,q,1
210374,49,3,2,4,6,f,Lauren.jpg,pieFS3.bmp,Lauren's car with her bag and credit cards was recently stolen.,2,na,838793,841504,2711,q,1
210374,50,3,3,7,10,m,Ricky.jpg,pieFS3.bmp,Ricky just bought an expensive sports car,1,resources,853660,856344,2684,q,1
210374,51,1,10,10,20,f,Janet.jpg,pieFS1.bmp,Janet is going to be evicted because she is behind on her rent,2,na,868526,877225,8699,q,1
210374,52,4,4,16,20,f,Fiona.jpg,pieFS4.bmp,Fiona owns an international company,1,resources,889437,892325,2888,q,1
210626,1,5,2,18,20,m,Justin.jpg,pieFS5.bmp,Justin just lost his job,2,na,76471,80407,3936,p,0
210626,2,4,3,12,15,f,Sharon.jpg,pieFS4.bmp,Sharon received a large inheritance from a distant relative,1,resources,92607,96915,4308,p,0
210626,3,4,1,4,5,f,Louise.jpg,pieFS4.bmp,Louise is a single mother,2,na,109110,113690,4580,q,1
210626,4,4,2,8,10,f,Maria.jpg,pieFS4.bmp,Maria just found out that her husband has incurred a large credit card debt.,2,na,125881,129159,3278,q,1
210626,5,2,6,9,15,m,Mark.jpg,pieFS2.bmp,Mark just found $50 on the street,1,resources,141348,144191,2843,p,0
210626,6,4,1,4,5,m,Saul.jpg,pieFS4.bmp,Saul is homeless,2,na,156363,161056,4693,q,1
210626,7,2,8,12,20,f,Jean.jpg,pieFS2.bmp,Jean is a highly paid actress,1,resources,173251,175208,1957,p,0
210626,8,4,4,16,20,m,Michael.jpg,pieFS4.bmp,Michael is saving to pay his university fees,2,na,187381,190064,2683,q,1
210626,9,3,3,7,10,m,Alan.jpg,pieFS3.bmp,Alan employs illegal immigrants and pays them less than minimum wage.,1,reputation,202279,207628,5349,p,0
210626,10,1,9,9,18,m,Brad.jpg,pieFS1.bmp,Brad lives in a luxury penthouse apartment,1,resources,219819,225328,5509,p,0
210626,11,3,3,7,10,f,Jackie.jpg,pieFS3.bmp,Jackie has to take an unpaid leave of absence because her mother broke her hip.,2,na,237526,240095,2569,q,1
210626,12,5,1,9,10,m,Matt.jpg,pieFS5.bmp,Matt stole money from his mother's wallet.,1,reputation,252274,253314,1040,p,0
210626,13,5,1,9,10,f,Kelly.jpg,pieFS5.bmp,Kelly got a large cash bonus from her boss,1,resources,265517,267450,1933,p,0
210626,14,3,2,4,6,f,Janet.jpg,pieFS3.bmp,Janet just won the lottery,1,resources,279629,284467,4838,q,1
210626,15,3,2,4,6,f,Jenny.jpg,pieFS3.bmp,Jenny was a victim of identity theft and is now thousands of dollars in debt.,2,na,296668,299577,2909,p,0
210626,16,4,2,8,10,f,Monica.jpg,pieFS4.bmp,Monica works two waitressing jobs to pay her bills.,2,na,311767,313484,1717,p,0
210626,17,3,6,14,20,m,Darnell.jpg,pieFS3.bmp,Darnell lost his life savings when his small business failed,2,na,325679,328235,2556,q,1
210626,18,3,5,11,16,m,Ricky.jpg,pieFS3.bmp,Ricky could not afford his mortgage and his home was foreclosed.,2,na,340426,345314,4888,p,0
210626,19,5,2,18,20,m,Joe.jpg,pieFS5.bmp,Joe is hiding his taxable income in Switzerland.,1,reputation,357498,358326,828,p,0
210626,20,4,3,12,15,m,Sam.jpg,pieFS4.bmp,Sam cheated on his taxes and is now under investigation for tax fraud.,1,reputation,370524,375389,4865,p,0
210626,21,1,8,8,16,m,Ben.jpg,pieFS1.bmp,Ben is a veteran having trouble finding employment.,2,na,387579,389171,1592,q,1
210626,22,4,1,4,5,m,Edward.jpg,pieFS4.bmp,Edward underreports his company's earnings and pockets the profits.,1,reputation,401390,403072,1682,p,0
210626,23,3,3,7,10,f,Lauren.jpg,pieFS3.bmp,Lauren just received a huge cash settlement,1,resources,415269,416248,979,p,0
210626,24,3,2,4,6,f,Deborah.jpg,pieFS3.bmp,Deborah takes discarded food from grocery stores to feed her children.,2,na,428428,430967,2539,q,1
210626,25,3,4,9,13,m,Peter.jpg,pieFS3.bmp,Peter stole his elderly father's prescription medications.,1,reputation,443159,444140,981,p,0
210626,26,2,7,10,17,f,Fiona.jpg,pieFS2.bmp,Fiona cannot afford to send her son to college.,2,na,456352,456938,586,q,1
210626,27,5,1,9,10,f,Emily.jpg,pieFS5.bmp,Emily steals her coworkers' tips to buy alcohol.,1,reputation,469127,470172,1045,p,0
210626,28,2,6,9,15,m,Don.jpg,pieFS2.bmp,Don declared bankruptcy after he was laid off.,2,na,482353,486345,3992,p,0
210626,29,3,4,9,13,m,Paul.jpg,pieFS3.bmp,Paul is a well paid lawyer,1,resources,498538,501783,3245,p,0
210626,30,4,2,8,10,m,Tony.jpg,pieFS4.bmp,Tony takes valuables from his friends' homes when asked to house-sit.,1,reputation,513972,515624,1652,q,1
210626,31,4,3,12,15,f,Eileen.jpg,pieFS4.bmp,Eileen just lost her small business after a franchise moved in next door.,2,na,527817,528769,952,p,0
210626,32,5,1,9,10,m,Daniel.jpg,pieFS5.bmp,Daniel is a retiree,2,na,540942,545004,4062,q,1
210626,33,4,4,16,20,f,Arianna.jpg,pieFS4.bmp,Arianna regularly fires employees to avoid promoting them.,1,reputation,557178,558176,998,p,0
210626,34,5,1,9,10,f,Trish.jpg,pieFS5.bmp,Trish secretly gambles with her husband's savings.,1,reputation,570371,571208,837,p,0
210626,35,3,5,11,16,f,Miriam.jpg,pieFS3.bmp,Miriam claims false expenses for her reportable work travel.,1,reputation,583397,584131,734,p,0
210626,36,5,1,9,10,f,Beth.jpg,pieFS5.bmp,Beth works as a cleaner in a hotel,2,na,596322,597287,965,q,1
210626,37,1,5,5,10,f,Fay.jpg,pieFS1.bmp,Fay's husband is a wealthy investment banker,1,resources,609464,610110,646,p,0
210626,38,4,4,16,20,f,Joanna.jpg,pieFS4.bmp,Joanna used her mother's social security number to open a credit card account.,1,reputation,622306,623158,852,p,0
210626,39,2,3,4,7,m,Stuart.jpg,pieFS2.bmp,Stuart was injured in a hit-and-run accident and cannot afford his medical bills.,2,na,635348,636519,1171,q,1
210626,40,1,10,10,20,f,Cindy.jpg,pieFS1.bmp,Cindy is raising money to buy gifts for children in need.,2,na,648708,649925,1217,q,1
210626,41,4,3,12,15,m,Ian.jpg,pieFS4.bmp,Ian was mugged and had his wallet stolen.,2,na,662118,663925,1807,q,1
210626,42,4,2,8,10,m,Taymar.jpg,pieFS4.bmp,Taymar just bought an expensive sports car,1,resources,676130,676738,608,p,0
210626,43,2,3,4,7,f,Sammy.jpg,pieFS2.bmp,Sammy illegally parks in the disabled parking spots when she can.,1,reputation,688939,689748,809,p,0
210626,44,3,6,14,20,m,Jared.jpg,pieFS3.bmp,Jared is saving for his son's operation,2,na,701931,702497,566,q,1
210626,45,5,1,9,10,f,Mary.jpg,pieFS5.bmp,Mary can't afford to pay her medical bills,2,na,714672,715912,1240,q,1
210626,46,5,1,9,10,f,Emma.jpg,pieFS5.bmp,Emma is going to be evicted because she is behind on her rent,2,na,728115,731116,3001,q,1
210626,47,5,2,18,20,m,Kevin.jpg,pieFS5.bmp,Kevin often goes through and steals the neighbors' mail.,1,reputation,743315,743971,656,p,0
210626,48,5,2,18,20,f,Kay.jpg,pieFS5.bmp,Kay owns an international company,1,resources,756190,756927,737,p,0
210626,49,3,4,9,13,m,George.jpg,pieFS3.bmp,George bullies his employees to put in extra hours at work.,1,reputation,769132,771040,1908,q,1
210626,50,3,2,4,6,f,Marny.jpg,pieFS3.bmp,Marny's car with her bag and credit cards was recently stolen.,2,na,783244,785869,2625,q,1
210626,51,5,2,18,20,m,Jack.jpg,pieFS5.bmp,Jack has been unable to find a job for over a year.,2,na,798042,799338,1296,q,1
210626,52,5,1,9,10,m,Nick.jpg,pieFS5.bmp,Nick lost his house in a fire,2,na,811552,812901,1349,q,1
210685,1,5,1,9,10,m,George.jpg,pieFS5.bmp,George bullies his employees to put in extra hours at work.,1,reputation,116788,127583,10795,p,0
210685,2,5,2,18,20,m,Peter.jpg,pieFS5.bmp,Peter was injured in a hit-and-run accident and cannot afford his medical bills.,2,na,139862,143423,3561,p,0
210685,3,3,5,11,16,m,Darnell.jpg,pieFS3.bmp,Darnell was mugged and had his wallet stolen.,2,na,155677,160183,4506,p,0
210685,4,2,6,9,15,m,Don.jpg,pieFS2.bmp,Don often goes through and steals the neighbors' mail.,1,reputation,172425,175443,3018,p,0
210685,5,4,4,16,20,m,Stuart.jpg,pieFS4.bmp,Stuart has been unable to find a job for over a year.,2,na,187692,302578,114886,p,0
210685,6,3,5,11,16,f,Jenny.jpg,pieFS3.bmp,Jenny got a large cash bonus from her boss,1,resources,314800,317945,3145,q,1
210685,7,2,3,4,7,m,Saul.jpg,pieFS2.bmp,Saul lost his house in a fire,2,na,330166,340225,10059,p,0
210685,8,3,4,9,13,m,Tony.jpg,pieFS3.bmp,Tony just found $50 on the street,1,resources,352458,357165,4707,q,1
210685,9,5,1,9,10,f,Eileen.jpg,pieFS5.bmp,Eileen was a victim of identity theft and is now thousands of dollars in debt.,2,na,369389,374626,5237,p,0
210685,10,5,2,18,20,m,Brad.jpg,pieFS5.bmp,Brad is homeless,2,na,386852,391726,4874,p,0
210685,11,3,6,14,20,m,Alan.jpg,pieFS3.bmp,Alan just lost his job,2,na,403950,407226,3276,q,1
210685,12,4,3,12,15,m,Ben.jpg,pieFS4.bmp,Ben is saving to pay his university fees,2,na,419449,423746,4297,q,1
210685,13,4,2,8,10,m,Nick.jpg,pieFS4.bmp,Nick lives in a luxury penthouse apartment,1,resources,435964,442606,6642,q,1
210685,14,4,4,16,20,f,Emma.jpg,pieFS4.bmp,Emma owns an international company,1,resources,454826,457987,3161,q,1
210685,15,2,8,12,20,f,Fay.jpg,pieFS2.bmp,Fay received a large inheritance from a distant relative,1,resources,470209,473227,3018,q,1
210685,16,4,2,8,10,m,Justin.jpg,pieFS4.bmp,Justin employs illegal immigrants and pays them less than minimum wage.,1,reputation,485442,491007,5565,p,0
210685,17,2,6,9,15,m,Jared.jpg,pieFS2.bmp,Jared could not afford his mortgage and his home was foreclosed.,2,na,503239,506607,3368,q,1
210685,18,3,3,7,10,f,Sammy.jpg,pieFS3.bmp,Sammy works two waitressing jobs to pay her bills.,2,na,518838,525087,6249,q,1
210685,19,2,3,4,7,f,Jackie.jpg,pieFS2.bmp,Jackie just received a huge cash settlement,1,resources,537334,539868,2534,q,1
210685,20,3,4,9,13,m,Paul.jpg,pieFS3.bmp,Paul is hiding his taxable income in Switzerland.,1,reputation,552101,555068,2967,q,1
210685,21,4,2,8,10,f,Jean.jpg,pieFS4.bmp,Jean takes discarded food from grocery stores to feed her children.,2,na,567301,571388,4087,p,0
210685,22,5,2,18,20,m,Mark.jpg,pieFS5.bmp,Mark stole money from his mother's wallet.,1,reputation,583616,586488,2872,p,0
210685,23,4,3,12,15,f,Janet.jpg,pieFS4.bmp,Janet is a single mother,2,na,598699,605328,6629,p,0
210685,24,4,1,4,5,m,Taymar.jpg,pieFS4.bmp,Taymar underreports his company's earnings and pockets the profits.,1,reputation,617545,620828,3283,p,0
210685,25,5,1,9,10,m,Jack.jpg,pieFS5.bmp,Jack lost his life savings when his small business failed,2,na,633061,635849,2788,p,0
210685,26,4,3,12,15,f,Lauren.jpg,pieFS4.bmp,Lauren steals her coworkers' tips to buy alcohol.,1,reputation,648077,650989,2912,p,0
210685,27,1,5,5,10,f,Mary.jpg,pieFS1.bmp,Mary just won the lottery,1,resources,663210,666369,3159,q,1
210685,28,5,2,18,20,m,Joe.jpg,pieFS5.bmp,Joe is a well paid lawyer,1,resources,678593,681029,2436,p,0
210685,29,2,7,10,17,f,Sharon.jpg,pieFS2.bmp,Sharon cannot afford to send her son to college.,2,na,693260,696069,2809,q,1
210685,30,4,2,8,10,f,Deborah.jpg,pieFS4.bmp,Deborah just lost her small business after a franchise moved in next door.,2,na,708293,711490,3197,p,0
210685,31,3,4,9,13,m,Sam.jpg,pieFS3.bmp,Sam cheated on his taxes and is now under investigation for tax fraud.,1,reputation,723726,726850,3124,q,1
210685,32,3,6,14,20,m,Ricky.jpg,pieFS3.bmp,Ricky is a retiree,2,na,739075,742230,3155,q,1
210685,33,3,3,7,10,f,Arianna.jpg,pieFS3.bmp,Arianna regularly fires employees to avoid promoting them.,1,reputation,754458,756970,2512,p,0
210685,34,5,1,9,10,f,Beth.jpg,pieFS5.bmp,Beth secretly gambles with her husband's savings.,1,reputation,769192,771390,2198,p,0
210685,35,4,1,4,5,m,Michael.jpg,pieFS4.bmp,Michael is a veteran having trouble finding employment.,2,na,783609,785611,2002,p,0
210685,36,3,3,7,10,m,Ian.jpg,pieFS3.bmp,Ian stole his elderly father's prescription medications.,1,reputation,797843,800271,2428,p,0
210685,37,4,4,16,20,f,Cindy.jpg,pieFS4.bmp,Cindy used her mother's social security number to open a credit card account.,1,reputation,812493,816571,4078,q,1
210685,38,1,8,8,16,m,Matt.jpg,pieFS1.bmp,Matt declared bankruptcy after he was laid off.,2,na,828792,831311,2519,q,1
210685,39,5,1,9,10,f,Monica.jpg,pieFS5.bmp,Monica is raising money to buy gifts for children in need.,2,na,843542,845911,2369,p,0
210685,40,5,1,9,10,f,Emily.jpg,pieFS5.bmp,Emily illegally parks in the disabled parking spots when she can.,1,reputation,858142,859951,1809,p,0
210685,41,3,2,4,6,f,Marny.jpg,pieFS3.bmp,Marny's car with her bag and credit cards was recently stolen.,2,na,872160,874331,2171,p,0
210685,42,4,3,12,15,m,Edward.jpg,pieFS4.bmp,Edward just bought an expensive sports car,1,resources,886544,888732,2188,p,0
210685,43,5,1,9,10,m,Daniel.jpg,pieFS5.bmp,Daniel is saving for his son's operation,2,na,900961,904012,3051,p,0
210685,44,5,1,9,10,f,Joanna.jpg,pieFS5.bmp,Joanna just found out that her husband has incurred a large credit card debt.,2,na,916228,918552,2324,p,0
210685,45,5,2,18,20,f,Kay.jpg,pieFS5.bmp,Kay claims false expenses for her reportable work travel.,1,reputation,930761,933832,3071,p,0
210685,46,1,9,9,18,m,Kevin.jpg,pieFS1.bmp,Kevin takes valuables from his friends' homes when asked to house-sit.,1,reputation,946044,948512,2468,q,1
210685,47,3,2,4,6,f,Kelly.jpg,pieFS3.bmp,Kelly is a highly paid actress,1,resources,960744,963213,2469,p,0
210685,48,3,2,4,6,f,Maria.jpg,pieFS3.bmp,Maria has to take an unpaid leave of absence because her mother broke her hip.,2,na,975445,978253,2808,p,0
210685,49,1,10,10,20,f,Louise.jpg,pieFS1.bmp,Louise works as a cleaner in a hotel,2,na,990461,993653,3192,q,1
210685,50,5,1,9,10,f,Miriam.jpg,pieFS5.bmp,Miriam's husband is a wealthy investment banker,1,resources,1005894,1008613,2719,p,0
210685,51,4,1,4,5,f,Fiona.jpg,pieFS4.bmp,Fiona can't afford to pay her medical bills,2,na,1020844,1023593,2749,p,0
210685,52,3,2,4,6,f,Trish.jpg,pieFS3.bmp,Trish is going to be evicted because she is behind on her rent,2,na,1035827,1037913,2086,p,0
210701,1,4,3,12,15,f,Cindy.jpg,pieFS4.bmp,Cindy works two waitressing jobs to pay her bills.,2,na,34380,37893,3513,z,1
210701,2,5,1,9,10,f,Jackie.jpg,pieFS5.bmp,Jackie just received a huge cash settlement,1,resources,49981,50080,99,z,1
210701,3,4,1,4,5,f,Maria.jpg,pieFS4.bmp,Maria takes discarded food from grocery stores to feed her children.,2,na,62170,64597,2427,z,1
210701,4,4,2,8,10,m,Taymar.jpg,pieFS4.bmp,Taymar is a well paid lawyer,1,resources,76684,78392,1708,z,1
210701,5,5,2,18,20,m,Paul.jpg,pieFS5.bmp,Paul is a retiree,2,na,90479,91746,1267,z,1
210701,6,3,2,4,6,f,Trish.jpg,pieFS3.bmp,Trish cannot afford to send her son to college.,2,na,103839,104809,970,z,1
210701,7,2,6,9,15,m,Ricky.jpg,pieFS2.bmp,Ricky just bought an expensive sports car,1,resources,116898,118121,1223,z,1
210701,8,3,3,7,10,f,Eileen.jpg,pieFS3.bmp,Eileen steals her coworkers' tips to buy alcohol.,1,reputation,130207,134846,4639,z,1
210701,9,3,5,11,16,m,Tony.jpg,pieFS3.bmp,Tony was injured in a hit-and-run accident and cannot afford his medical bills.,2,na,146945,147708,763,z,1
210701,10,4,2,8,10,f,Sammy.jpg,pieFS4.bmp,Sammy just lost her small business after a franchise moved in next door.,2,na,159820,160007,187,z,1
210701,11,3,6,14,20,m,Ian.jpg,pieFS3.bmp,Ian was mugged and had his wallet stolen.,2,na,172110,173136,1026,z,1
210701,12,3,5,11,16,f,Emily.jpg,pieFS3.bmp,Emily used her mother's social security number to open a credit card account.,1,reputation,185236,190194,4958,z,1
210701,13,4,1,4,5,m,Stuart.jpg,pieFS4.bmp,Stuart often goes through and steals the neighbors' mail.,1,reputation,202291,210485,8194,m,0
210701,14,4,3,12,15,f,Janet.jpg,pieFS4.bmp,Janet regularly fires employees to avoid promoting them.,1,reputation,222590,229722,7132,m,0
210701,15,3,6,14,20,m,Jared.jpg,pieFS3.bmp,Jared is saving for his son's operation,2,na,241836,241904,68,z,1
210701,16,5,1,9,10,f,Beth.jpg,pieFS5.bmp,Beth secretly gambles with her husband's savings.,1,reputation,253992,254391,399,z,1
210701,17,5,1,9,10,m,Nick.jpg,pieFS5.bmp,Nick has been unable to find a job for over a year.,2,na,266483,266691,208,z,1
210701,18,3,4,9,13,m,Daniel.jpg,pieFS3.bmp,Daniel bullies his employees to put in extra hours at work.,1,reputation,278789,278822,33,m,0
210701,19,4,3,12,15,m,Brad.jpg,pieFS4.bmp,Brad lost his house in a fire,2,na,290912,291796,884,z,1
210701,20,4,4,16,20,f,Miriam.jpg,pieFS4.bmp,Miriam claims false expenses for her reportable work travel.,1,reputation,303887,304865,978,z,1
210701,21,5,1,9,10,f,Fay.jpg,pieFS5.bmp,Fay works as a cleaner in a hotel,2,na,316963,316977,14,z,1
210701,22,4,2,8,10,f,Monica.jpg,pieFS4.bmp,Monica is raising money to buy gifts for children in need.,2,na,329069,329164,95,z,1
210701,23,5,2,18,20,m,Sam.jpg,pieFS5.bmp,Sam just found $50 on the street,1,resources,341258,342086,828,z,1
210701,24,4,4,16,20,f,Emma.jpg,pieFS4.bmp,Emma's husband is a wealthy investment banker,1,resources,354184,354231,47,z,1
210701,25,3,2,4,6,f,Mary.jpg,pieFS3.bmp,Mary can't afford to pay her medical bills,2,na,366323,366756,433,z,1
210701,26,4,1,4,5,m,Jack.jpg,pieFS4.bmp,Jack is homeless,2,na,378847,379716,869,z,1
210701,27,5,2,18,20,f,Joanna.jpg,pieFS5.bmp,Joanna illegally parks in the disabled parking spots when she can.,1,reputation,391805,396272,4467,m,0
210701,28,5,2,18,20,m,Kevin.jpg,pieFS5.bmp,Kevin is saving to pay his university fees,2,na,408359,409134,775,z,1
210701,29,3,3,7,10,f,Jenny.jpg,pieFS3.bmp,Jenny's car with her bag and credit cards was recently stolen.,2,na,421234,421710,476,z,1
210701,30,4,4,16,20,m,Edward.jpg,pieFS4.bmp,Edward just lost his job,2,na,433808,434685,877,z,1
210701,31,5,1,9,10,f,Lauren.jpg,pieFS5.bmp,Lauren just found out that her husband has incurred a large credit card debt.,2,na,446784,447491,707,z,1
210701,32,1,10,10,20,f,Sharon.jpg,pieFS1.bmp,Sharon is going to be evicted because she is behind on her rent,2,na,459575,459678,103,z,1
210701,33,4,3,12,15,m,Alan.jpg,pieFS4.bmp,Alan employs illegal immigrants and pays them less than minimum wage.,1,reputation,471765,472858,1093,m,0
210701,34,2,6,9,15,m,Joe.jpg,pieFS2.bmp,Joe could not afford his mortgage and his home was foreclosed.,2,na,484958,486231,1273,z,1
210701,35,5,2,18,20,m,Mark.jpg,pieFS5.bmp,Mark lives in a luxury penthouse apartment,1,resources,498317,501155,2838,z,1
210701,36,3,4,9,13,m,Michael.jpg,pieFS3.bmp,Michael stole money from his mother's wallet.,1,reputation,513233,515794,2561,m,0
210701,37,2,8,12,20,f,Marny.jpg,pieFS2.bmp,Marny is a highly paid actress,1,resources,527863,532974,5111,z,1
210701,38,1,5,5,10,f,Arianna.jpg,pieFS1.bmp,Arianna owns an international company,1,resources,545069,547351,2282,z,1
210701,39,5,1,9,10,f,Deborah.jpg,pieFS5.bmp,Deborah has to take an unpaid leave of absence because her mother broke her hip.,2,na,559449,561980,2531,z,1
210701,40,2,3,4,7,m,Ben.jpg,pieFS2.bmp,Ben lost his life savings when his small business failed,2,na,574080,575004,924,z,1
210701,41,3,4,9,13,m,George.jpg,pieFS3.bmp,George is hiding his taxable income in Switzerland.,1,reputation,587122,587231,109,z,1
210701,42,4,2,8,10,m,Matt.jpg,pieFS4.bmp,Matt cheated on his taxes and is now under investigation for tax fraud.,1,reputation,599328,599488,160,z,1
210701,43,5,1,9,10,m,Don.jpg,pieFS5.bmp,Don is a veteran having trouble finding employment.,2,na,611585,612672,1087,z,1
210701,44,2,3,4,7,f,Louise.jpg,pieFS2.bmp,Louise received a large inheritance from a distant relative,1,resources,624761,625346,585,z,1
210701,45,1,9,9,18,m,Saul.jpg,pieFS1.bmp,Saul stole his elderly father's prescription medications.,1,reputation,637435,639976,2541,m,0
210701,46,2,7,10,17,f,Kay.jpg,pieFS2.bmp,Kay is a single mother,2,na,652049,653789,1740,z,1
210701,47,3,2,4,6,f,Fiona.jpg,pieFS3.bmp,Fiona just won the lottery,1,resources,665877,668339,2462,z,1
210701,48,1,8,8,16,m,Peter.jpg,pieFS1.bmp,Peter declared bankruptcy after he was laid off.,2,na,680425,682082,1657,z,1
210701,49,3,3,7,10,m,Justin.jpg,pieFS3.bmp,Justin underreports his company's earnings and pockets the profits.,1,reputation,694169,697311,3142,z,1
210701,50,5,1,9,10,f,Kelly.jpg,pieFS5.bmp,Kelly got a large cash bonus from her boss,1,resources,709402,710206,804,z,1
210701,51,5,1,9,10,m,Darnell.jpg,pieFS5.bmp,Darnell takes valuables from his friends' homes when asked to house-sit.,1,reputation,722294,724835,2541,m,0
210701,52,3,2,4,6,f,Jean.jpg,pieFS3.bmp,Jean was a victim of identity theft and is now thousands of dollars in debt.,2,na,736924,737317,393,z,1
211038,1,4,4,16,20,f,Jean.jpg,pieFS4.bmp,Jean just received a huge cash settlement,1,resources,163396,166459,3063,q,1
211038,2,5,1,9,10,f,Eileen.jpg,pieFS5.bmp,Eileen takes discarded food from grocery stores to feed her children.,2,na,178729,181239,2510,p,0
211038,3,5,1,9,10,m,Ben.jpg,pieFS5.bmp,Ben was mugged and had his wallet stolen.,2,na,193496,196980,3484,q,1
211038,4,3,6,14,20,m,Jared.jpg,pieFS3.bmp,Jared could not afford his mortgage and his home was foreclosed.,2,na,209228,212080,2852,q,1
211038,5,5,1,9,10,f,Sammy.jpg,pieFS5.bmp,Sammy steals her coworkers' tips to buy alcohol.,1,reputation,224328,229060,4732,p,0
211038,6,3,4,9,13,m,Taymar.jpg,pieFS3.bmp,Taymar is hiding his taxable income in Switzerland.,1,reputation,241326,247320,5994,p,0
211038,7,2,6,9,15,m,Paul.jpg,pieFS2.bmp,Paul underreports his company's earnings and pockets the profits.,1,reputation,259572,262040,2468,q,1
211038,8,4,2,8,10,m,Alan.jpg,pieFS4.bmp,Alan is a well paid lawyer,1,resources,274305,276320,2015,q,1
211038,9,5,2,18,20,m,Nick.jpg,pieFS5.bmp,Nick often goes through and steals the neighbors' mail.,1,reputation,288606,293401,4795,p,0
211038,10,4,3,12,15,m,Peter.jpg,pieFS4.bmp,Peter has been unable to find a job for over a year.,2,na,305654,307321,1667,q,1
211038,11,2,6,9,15,m,Stuart.jpg,pieFS2.bmp,Stuart lost his house in a fire,2,na,319571,321641,2070,q,1
211038,12,4,4,16,20,f,Beth.jpg,pieFS4.bmp,Beth regularly fires employees to avoid promoting them.,1,reputation,333889,337061,3172,q,1
211038,13,1,8,8,16,m,Ricky.jpg,pieFS1.bmp,Ricky is a retiree,2,na,349322,351081,1759,q,1
211038,14,3,2,4,6,f,Lauren.jpg,pieFS3.bmp,Lauren just lost her small business after a franchise moved in next door.,2,na,363339,365082,1743,q,1
211038,15,3,3,7,10,m,Darnell.jpg,pieFS3.bmp,Darnell just found $50 on the street,1,resources,377324,381081,3757,q,1
211038,16,1,5,5,10,f,Marny.jpg,pieFS1.bmp,Marny used her mother's social security number to open a credit card account.,1,reputation,393372,395922,2550,q,1
211038,17,5,1,9,10,m,Kevin.jpg,pieFS5.bmp,Kevin is homeless,2,na,408172,410302,2130,q,1
211038,18,4,3,12,15,m,Joe.jpg,pieFS4.bmp,Joe just bought an expensive sports car,1,resources,422556,424882,2326,q,1
211038,19,4,2,8,10,f,Deborah.jpg,pieFS4.bmp,Deborah is raising money to buy gifts for children in need.,2,na,437157,439742,2585,q,1
211038,20,5,2,18,20,m,George.jpg,pieFS5.bmp,George is saving for his son's operation,2,na,451990,454022,2032,q,1
211038,21,5,2,18,20,f,Emily.jpg,pieFS5.bmp,Emily illegally parks in the disabled parking spots when she can.,1,reputation,466291,471003,4712,p,0
211038,22,4,1,4,5,m,Michael.jpg,pieFS4.bmp,Michael is saving to pay his university fees,2,na,483272,485963,2691,q,1
211038,23,3,4,9,13,m,Mark.jpg,pieFS3.bmp,Mark lives in a luxury penthouse apartment,1,resources,498222,501423,3201,q,1
211038,24,3,2,4,6,f,Maria.jpg,pieFS3.bmp,Maria's car with her bag and credit cards was recently stolen.,2,na,513688,516123,2435,q,1
211038,25,2,8,12,20,f,Mary.jpg,pieFS2.bmp,Mary secretly gambles with her husband's savings.,1,reputation,528388,532383,3995,q,1
211038,26,5,1,9,10,f,Kelly.jpg,pieFS5.bmp,Kelly just found out that her husband has incurred a large credit card debt.,2,na,544670,549483,4813,q,1
211038,27,3,2,4,6,f,Monica.jpg,pieFS3.bmp,Monica is a highly paid actress,1,resources,561734,564203,2469,q,1
211038,28,5,1,9,10,f,Kay.jpg,pieFS5.bmp,Kay claims false expenses for her reportable work travel.,1,reputation,576434,578604,2170,p,0
211038,29,5,1,9,10,m,Justin.jpg,pieFS5.bmp,Justin bullies his employees to put in extra hours at work.,1,reputation,590835,592944,2109,p,0
211038,30,4,3,12,15,f,Jenny.jpg,pieFS4.bmp,Jenny has to take an unpaid leave of absence because her mother broke her hip.,2,na,605169,607824,2655,q,1
211038,31,4,2,8,10,f,Fiona.jpg,pieFS4.bmp,Fiona works as a cleaner in a hotel,2,na,620036,622184,2148,q,1
211038,32,3,5,11,16,f,Joanna.jpg,pieFS3.bmp,Joanna got a large cash bonus from her boss,1,resources,634403,636824,2421,q,1
211038,33,4,3,12,15,f,Miriam.jpg,pieFS4.bmp,Miriam's husband is a wealthy investment banker,1,resources,649037,654684,5647,p,0
211038,34,2,3,4,7,m,Daniel.jpg,pieFS2.bmp,Daniel just lost his job,2,na,666917,669085,2168,q,1
211038,35,4,2,8,10,m,Jack.jpg,pieFS4.bmp,Jack stole money from his mother's wallet.,1,reputation,681317,685565,4248,p,0
211038,36,2,7,10,17,f,Trish.jpg,pieFS2.bmp,Trish can't afford to pay her medical bills,2,na,697782,699425,1643,q,1
211038,37,3,6,14,20,m,Brad.jpg,pieFS3.bmp,Brad lost his life savings when his small business failed,2,na,711650,713385,1735,q,1
211038,38,5,1,9,10,f,Fay.jpg,pieFS5.bmp,Fay is going to be evicted because she is behind on her rent,2,na,725618,727325,1707,q,1
211038,39,1,9,9,18,m,Sam.jpg,pieFS1.bmp,Sam cheated on his taxes and is now under investigation for tax fraud.,1,reputation,739535,741885,2350,q,1
211038,40,2,3,4,7,f,Emma.jpg,pieFS2.bmp,Emma owns an international company,1,resources,754102,755866,1764,q,1
211038,41,3,5,11,16,m,Don.jpg,pieFS3.bmp,Don is a veteran having trouble finding employment.,2,na,768087,769926,1839,q,1
211038,42,4,1,4,5,m,Matt.jpg,pieFS4.bmp,Matt stole his elderly father's prescription medications.,1,reputation,782171,784946,2775,p,0
211038,43,3,3,7,10,f,Louise.jpg,pieFS3.bmp,Louise received a large inheritance from a distant relative,1,resources,797188,799226,2038,q,1
211038,44,3,2,4,6,f,Sharon.jpg,pieFS3.bmp,Sharon is a single mother,2,na,811455,813266,1811,q,1
211038,45,1,10,10,20,f,Jackie.jpg,pieFS1.bmp,Jackie was a victim of identity theft and is now thousands of dollars in debt.,2,na,825523,827286,1763,q,1
211038,46,4,4,16,20,m,Tony.jpg,pieFS4.bmp,Tony declared bankruptcy after he was laid off.,2,na,839507,841006,1499,q,1
211038,47,5,2,18,20,m,Ian.jpg,pieFS5.bmp,Ian takes valuables from his friends' homes when asked to house-sit.,1,reputation,853242,855047,1805,p,0
211038,48,3,4,9,13,m,Edward.jpg,pieFS3.bmp,Edward employs illegal immigrants and pays them less than minimum wage.,1,reputation,867276,870807,3531,q,1
211038,49,5,2,18,20,m,Saul.jpg,pieFS5.bmp,Saul was injured in a hit-and-run accident and cannot afford his medical bills.,2,na,883025,884867,1842,q,1
211038,50,5,1,9,10,f,Janet.jpg,pieFS5.bmp,Janet just won the lottery,1,resources,897093,898967,1874,q,1
211038,51,3,3,7,10,f,Arianna.jpg,pieFS3.bmp,Arianna cannot afford to send her son to college.,2,na,911194,913107,1913,q,1
211038,52,4,1,4,5,f,Cindy.jpg,pieFS4.bmp,Cindy works two waitressing jobs to pay her bills.,2,na,925328,927567,2239,q,1
211253,1,3,4,9,13,m,Edward.jpg,pieFS3.bmp,Edward just bought an expensive sports car,1,resources,25121,28992,3871,m,0
211253,2,4,1,4,5,f,Janet.jpg,pieFS4.bmp,Janet cannot afford to send her son to college.,2,na,41106,43003,1897,z,1
211253,3,4,4,16,20,m,Taymar.jpg,pieFS4.bmp,Taymar is saving for his son's operation,2,na,55102,57681,2579,z,1
211253,4,5,2,18,20,m,Kevin.jpg,pieFS5.bmp,Kevin lives in a luxury penthouse apartment,1,resources,69783,72525,2742,m,0
211253,5,4,2,8,10,m,Mark.jpg,pieFS4.bmp,Mark stole money from his mother's wallet.,1,reputation,84614,86682,2068,m,0
211253,6,1,10,10,20,f,Jean.jpg,pieFS1.bmp,Jean is raising money to buy gifts for children in need.,2,na,98794,100882,2088,z,1
211253,7,4,3,12,15,m,Don.jpg,pieFS4.bmp,Don lost his life savings when his small business failed,2,na,112973,116387,3414,m,0
211253,8,5,1,9,10,f,Cindy.jpg,pieFS5.bmp,Cindy illegally parks in the disabled parking spots when she can.,1,reputation,128473,131278,2805,m,0
211253,9,3,2,4,6,f,Maria.jpg,pieFS3.bmp,Maria's car with her bag and credit cards was recently stolen.,2,na,143371,145138,1767,z,1
211253,10,5,1,9,10,m,Brad.jpg,pieFS5.bmp,Brad cheated on his taxes and is now under investigation for tax fraud.,1,reputation,157233,158761,1528,m,0
211253,11,2,7,10,17,f,Jenny.jpg,pieFS2.bmp,Jenny just found out that her husband has incurred a large credit card debt.,2,na,170877,174921,4044,m,0
211253,12,1,5,5,10,f,Kelly.jpg,pieFS1.bmp,Kelly is a highly paid actress,1,resources,187013,188687,1674,z,1
211253,13,3,2,4,6,f,Jackie.jpg,pieFS3.bmp,Jackie has to take an unpaid leave of absence because her mother broke her hip.,2,na,200774,204298,3524,z,1
211253,14,2,3,4,7,m,Jack.jpg,pieFS2.bmp,Jack is a veteran having trouble finding employment.,2,na,216392,218392,2000,z,1
211253,15,4,1,4,5,m,Jared.jpg,pieFS4.bmp,Jared bullies his employees to put in extra hours at work.,1,reputation,230487,231971,1484,m,0
211253,16,3,4,9,13,m,Michael.jpg,pieFS3.bmp,Michael stole his elderly father's prescription medications.,1,reputation,244065,246018,1953,m,0
211253,17,5,1,9,10,m,Darnell.jpg,pieFS5.bmp,Darnell declared bankruptcy after he was laid off.,2,na,258127,260347,2220,z,1
211253,18,5,2,18,20,f,Fay.jpg,pieFS5.bmp,Fay regularly fires employees to avoid promoting them.,1,reputation,272440,273411,971,m,0
211253,19,3,5,11,16,f,Sammy.jpg,pieFS3.bmp,Sammy got a large cash bonus from her boss,1,resources,285499,289182,3683,z,1
211253,20,4,3,12,15,f,Arianna.jpg,pieFS4.bmp,Arianna secretly gambles with her husband's savings.,1,reputation,301300,302318,1018,m,0
211253,21,3,4,9,13,m,Peter.jpg,pieFS3.bmp,Peter takes valuables from his friends' homes when asked to house-sit.,1,reputation,314409,315569,1160,m,0
211253,22,5,2,18,20,m,Ricky.jpg,pieFS5.bmp,Ricky just lost his job,2,na,327652,328960,1308,z,1
211253,23,3,5,11,16,m,Ben.jpg,pieFS3.bmp,Ben was injured in a hit-and-run accident and cannot afford his medical bills.,2,na,341046,342392,1346,z,1
211253,24,3,3,7,10,f,Marny.jpg,pieFS3.bmp,Marny was a victim of identity theft and is now thousands of dollars in debt.,2,na,354489,355602,1113,z,1
211253,25,5,1,9,10,f,Deborah.jpg,pieFS5.bmp,Deborah works two waitressing jobs to pay her bills.,2,na,367699,369462,1763,z,1
211253,26,2,8,12,20,f,Trish.jpg,pieFS2.bmp,Trish claims false expenses for her reportable work travel.,1,reputation,381560,382682,1122,m,0
211253,27,4,4,16,20,f,Emily.jpg,pieFS4.bmp,Emily just received a huge cash settlement,1,resources,394770,396636,1866,z,1
211253,28,3,6,14,20,m,Sam.jpg,pieFS3.bmp,Sam was mugged and had his wallet stolen.,2,na,408732,409871,1139,z,1
211253,29,3,2,4,6,f,Louise.jpg,pieFS3.bmp,Louise works as a cleaner in a hotel,2,na,421958,423246,1288,z,1
211253,30,5,1,9,10,f,Emma.jpg,pieFS5.bmp,Emma's husband is a wealthy investment banker,1,resources,435335,438091,2756,z,1
211253,31,4,2,8,10,f,Eileen.jpg,pieFS4.bmp,Eileen takes discarded food from grocery stores to feed her children.,2,na,450183,451967,1784,z,1
211253,32,4,2,8,10,m,Tony.jpg,pieFS4.bmp,Tony often goes through and steals the neighbors' mail.,1,reputation,464061,465875,1814,m,0
211253,33,3,2,4,6,f,Joanna.jpg,pieFS3.bmp,Joanna steals her coworkers' tips to buy alcohol.,1,reputation,477956,479484,1528,m,0
211253,34,5,1,9,10,f,Fiona.jpg,pieFS5.bmp,Fiona can't afford to pay her medical bills,2,na,491584,494594,3010,z,1
211253,35,4,3,12,15,f,Beth.jpg,pieFS4.bmp,Beth is going to be evicted because she is behind on her rent,2,na,506683,509563,2880,z,1
211253,36,4,2,8,10,f,Lauren.jpg,pieFS4.bmp,Lauren just lost her small business after a franchise moved in next door.,2,na,521648,523248,1600,z,1
211253,37,1,8,8,16,m,Ian.jpg,pieFS1.bmp,Ian has been unable to find a job for over a year.,2,na,535342,537659,2317,z,1
211253,38,5,1,9,10,m,Matt.jpg,pieFS5.bmp,Matt lost his house in a fire,2,na,549739,556488,6749,z,1
211253,39,2,6,9,15,m,George.jpg,pieFS2.bmp,George employs illegal immigrants and pays them less than minimum wage.,1,reputation,568584,569801,1217,m,0
211253,40,3,6,14,20,m,Daniel.jpg,pieFS3.bmp,Daniel could not afford his mortgage and his home was foreclosed.,2,na,581893,583846,1953,m,0
211253,41,4,3,12,15,m,Joe.jpg,pieFS4.bmp,Joe is hiding his taxable income in Switzerland.,1,reputation,595939,597959,2020,m,0
211253,42,4,4,16,20,f,Miriam.jpg,pieFS4.bmp,Miriam owns an international company,1,resources,610051,613131,3080,m,0
211253,43,3,3,7,10,f,Sharon.jpg,pieFS3.bmp,Sharon received a large inheritance from a distant relative,1,resources,625201,626554,1353,z,1
211253,44,3,3,7,10,m,Saul.jpg,pieFS3.bmp,Saul just found $50 on the street,1,resources,638627,641463,2836,z,1
211253,45,5,1,9,10,f,Mary.jpg,pieFS5.bmp,Mary is a single mother,2,na,653542,656509,2967,z,1
211253,46,1,9,9,18,m,Paul.jpg,pieFS1.bmp,Paul underreports his company's earnings and pockets the profits.,1,reputation,668608,670556,1948,m,0
211253,47,5,1,9,10,f,Monica.jpg,pieFS5.bmp,Monica used her mother's social security number to open a credit card account.,1,reputation,682654,684072,1418,m,0
211253,48,4,1,4,5,m,Stuart.jpg,pieFS4.bmp,Stuart is homeless,2,na,696147,697526,1379,z,1
211253,49,5,2,18,20,m,Justin.jpg,pieFS5.bmp,Justin is a well paid lawyer,1,resources,709624,713355,3731,m,0
211253,50,2,6,9,15,m,Nick.jpg,pieFS2.bmp,Nick is saving to pay his university fees,2,na,725442,727200,1758,z,1
211253,51,2,3,4,7,f,Kay.jpg,pieFS2.bmp,Kay just won the lottery,1,resources,739270,740347,1077,m,0
211253,52,5,2,18,20,m,Alan.jpg,pieFS5.bmp,Alan is a retiree,2,na,752446,757270,4824,z,1
211669,1,4,3,12,15,m,Justin.jpg,pieFS4.bmp,Justin is hiding his taxable income in Switzerland.,1,reputation,135616,137667,2051,q,1
211669,2,5,1,9,10,m,Jack.jpg,pieFS5.bmp,Jack lives in a luxury penthouse apartment,1,resources,149934,151427,1493,q,1
211669,3,3,3,7,10,m,Alan.jpg,pieFS3.bmp,Alan underreports his company's earnings and pockets the profits.,1,reputation,163685,165087,1402,q,1
211669,4,4,3,12,15,f,Sammy.jpg,pieFS4.bmp,Sammy takes discarded food from grocery stores to feed her children.,2,na,177320,178768,1448,q,1
211669,5,5,2,18,20,m,Ben.jpg,pieFS5.bmp,Ben stole money from his mother's wallet.,1,reputation,190988,192548,1560,q,1
211669,6,4,3,12,15,m,Matt.jpg,pieFS4.bmp,Matt lost his life savings when his small business failed,2,na,204772,205808,1036,q,1
211669,7,3,4,9,13,m,Mark.jpg,pieFS3.bmp,Mark cheated on his taxes and is now under investigation for tax fraud.,1,reputation,218041,219248,1207,q,1
211669,8,3,6,14,20,m,Michael.jpg,pieFS3.bmp,Michael is a veteran having trouble finding employment.,2,na,231476,232728,1252,q,1
211669,9,4,1,4,5,m,Paul.jpg,pieFS4.bmp,Paul is a well paid lawyer,1,resources,244961,246188,1227,q,1
211669,10,4,4,16,20,f,Monica.jpg,pieFS4.bmp,Monica steals her coworkers' tips to buy alcohol.,1,reputation,258429,259628,1199,q,1
211669,11,5,1,9,10,f,Fiona.jpg,pieFS5.bmp,Fiona owns an international company,1,resources,271864,273149,1285,q,1
211669,12,3,6,14,20,m,Ricky.jpg,pieFS3.bmp,Ricky is a retiree,2,na,285382,286569,1187,q,1
211669,13,2,7,10,17,f,Maria.jpg,pieFS2.bmp,Maria just lost her small business after a franchise moved in next door.,2,na,298817,299869,1052,q,1
211669,14,4,3,12,15,f,Fay.jpg,pieFS4.bmp,Fay received a large inheritance from a distant relative,1,resources,312102,313189,1087,q,1
211669,15,4,1,4,5,f,Trish.jpg,pieFS4.bmp,Trish is a single mother,2,na,325421,326449,1028,q,1
211669,16,1,5,5,10,f,Miriam.jpg,pieFS1.bmp,Miriam just won the lottery,1,resources,338689,340009,1320,q,1
211669,17,3,4,9,13,m,George.jpg,pieFS3.bmp,George just bought an expensive sports car,1,resources,352241,353510,1269,q,1
211669,18,2,6,9,15,m,Brad.jpg,pieFS2.bmp,Brad stole his elderly father's prescription medications.,1,reputation,365742,366809,1067,q,1
211669,19,5,1,9,10,f,Marny.jpg,pieFS5.bmp,Marny used her mother's social security number to open a credit card account.,1,reputation,379044,380290,1246,q,1
211669,20,4,2,8,10,f,Emma.jpg,pieFS4.bmp,Emma cannot afford to send her son to college.,2,na,392513,393870,1357,q,1
211669,21,3,5,11,16,f,Sharon.jpg,pieFS3.bmp,Sharon regularly fires employees to avoid promoting them.,1,reputation,406097,407150,1053,q,1
211669,22,5,1,9,10,f,Kelly.jpg,pieFS5.bmp,Kelly is raising money to buy gifts for children in need.,2,na,419382,420410,1028,q,1
211669,23,3,5,11,16,m,Peter.jpg,pieFS3.bmp,Peter declared bankruptcy after he was laid off.,2,na,432634,433771,1137,q,1
211669,24,5,1,9,10,f,Lauren.jpg,pieFS5.bmp,Lauren illegally parks in the disabled parking spots when she can.,1,reputation,446003,447250,1247,q,1
211669,25,5,2,18,20,m,Darnell.jpg,pieFS5.bmp,Darnell takes valuables from his friends' homes when asked to house-sit.,1,reputation,459471,460871,1400,q,1
211669,26,1,10,10,20,f,Cindy.jpg,pieFS1.bmp,Cindy's car with her bag and credit cards was recently stolen.,2,na,473106,474131,1025,q,1
211669,27,4,4,16,20,f,Mary.jpg,pieFS4.bmp,Mary secretly gambles with her husband's savings.,1,reputation,486358,487451,1093,q,1
211669,28,1,8,8,16,m,Saul.jpg,pieFS1.bmp,Saul was injured in a hit-and-run accident and cannot afford his medical bills.,2,na,499676,500651,975,q,1
211669,29,2,3,4,7,f,Louise.jpg,pieFS2.bmp,Louise claims false expenses for her reportable work travel.,1,reputation,512895,513931,1036,q,1
211669,30,3,3,7,10,f,Eileen.jpg,pieFS3.bmp,Eileen just found out that her husband has incurred a large credit card debt.,2,na,526163,527251,1088,q,1
211669,31,4,4,16,20,m,Ian.jpg,pieFS4.bmp,Ian was mugged and had his wallet stolen.,2,na,539482,540571,1089,q,1
211669,32,5,2,18,20,f,Emily.jpg,pieFS5.bmp,Emily is a highly paid actress,1,resources,552800,553892,1092,q,1
211669,33,3,2,4,6,f,Deborah.jpg,pieFS3.bmp,Deborah has to take an unpaid leave of absence because her mother broke her hip.,2,na,566118,567112,994,q,1
211669,34,5,2,18,20,m,Daniel.jpg,pieFS5.bmp,Daniel is saving for his son's operation,2,na,579337,580412,1075,q,1
211669,35,2,8,12,20,f,Joanna.jpg,pieFS2.bmp,Joanna got a large cash bonus from her boss,1,resources,592639,593612,973,q,1
211669,36,3,2,4,6,f,Jackie.jpg,pieFS3.bmp,Jackie was a victim of identity theft and is now thousands of dollars in debt.,2,na,605841,606872,1031,q,1
211669,37,4,2,8,10,m,Nick.jpg,pieFS4.bmp,Nick often goes through and steals the neighbors' mail.,1,reputation,619093,620092,999,q,1
211669,38,5,1,9,10,f,Beth.jpg,pieFS5.bmp,Beth works as a cleaner in a hotel,2,na,632311,633033,722,q,1
211669,39,3,4,9,13,m,Taymar.jpg,pieFS3.bmp,Taymar bullies his employees to put in extra hours at work.,1,reputation,645247,646373,1126,q,1
211669,40,2,6,9,15,m,Sam.jpg,pieFS2.bmp,Sam has been unable to find a job for over a year.,2,na,658598,659533,935,q,1
211669,41,5,2,18,20,m,Stuart.jpg,pieFS5.bmp,Stuart lost his house in a fire,2,na,671750,672713,963,q,1
211669,42,3,2,4,6,f,Arianna.jpg,pieFS3.bmp,Arianna's husband is a wealthy investment banker,1,resources,684936,685873,937,q,1
211669,43,5,1,9,10,m,Jared.jpg,pieFS5.bmp,Jared just lost his job,2,na,698104,698933,829,q,1
211669,44,4,2,8,10,m,Edward.jpg,pieFS4.bmp,Edward employs illegal immigrants and pays them less than minimum wage.,1,reputation,711156,712093,937,q,1
211669,45,4,2,8,10,f,Janet.jpg,pieFS4.bmp,Janet can't afford to pay her medical bills,2,na,724325,725314,989,q,1
211669,46,1,9,9,18,m,Kevin.jpg,pieFS1.bmp,Kevin just found $50 on the street,1,resources,737544,738674,1130,q,1
211669,47,5,1,9,10,f,Kay.jpg,pieFS5.bmp,Kay is going to be evicted because she is behind on her rent,2,na,750895,751634,739,q,1
211669,48,3,2,4,6,f,Jean.jpg,pieFS3.bmp,Jean works two waitressing jobs to pay her bills.,2,na,763881,764834,953,q,1
211669,49,2,3,4,7,m,Tony.jpg,pieFS2.bmp,Tony is homeless,2,na,777066,777995,929,q,1
211669,50,4,1,4,5,m,Don.jpg,pieFS4.bmp,Don is saving to pay his university fees,2,na,790218,791075,857,q,1
211669,51,3,3,7,10,f,Jenny.jpg,pieFS3.bmp,Jenny just received a huge cash settlement,1,resources,803303,804254,951,q,1
211669,52,5,1,9,10,m,Joe.jpg,pieFS5.bmp,Joe could not afford his mortgage and his home was foreclosed.,2,na,816489,817415,926,q,1
212019,1,5,1,9,10,m,Jared.jpg,pieFS5.bmp,Jared is hiding his taxable income in Switzerland.,1,reputation,36390,39100,2710,m,0
212019,2,3,6,14,20,m,Nick.jpg,pieFS3.bmp,Nick is homeless,2,na,51204,53104,1900,z,1
212019,3,4,1,4,5,m,Tony.jpg,pieFS4.bmp,Tony is saving to pay his university fees,2,na,65216,67035,1819,z,1
212019,4,4,2,8,10,f,Jean.jpg,pieFS4.bmp,Jean takes discarded food from grocery stores to feed her children.,2,na,79128,81200,2072,z,1
212019,5,4,2,8,10,m,Joe.jpg,pieFS4.bmp,Joe underreports his company's earnings and pockets the profits.,1,reputation,93291,95622,2331,m,0
212019,6,4,3,12,15,m,Stuart.jpg,pieFS4.bmp,Stuart lives in a luxury penthouse apartment,1,resources,107721,111377,3656,z,1
212019,7,3,3,7,10,f,Jenny.jpg,pieFS3.bmp,Jenny steals her coworkers' tips to buy alcohol.,1,reputation,123472,124652,1180,m,0
212019,8,3,2,4,6,f,Miriam.jpg,pieFS3.bmp,Miriam is a single mother,2,na,136748,138451,1703,z,1
212019,9,4,2,8,10,f,Eileen.jpg,pieFS4.bmp,Eileen just lost her small business after a franchise moved in next door.,2,na,150543,152607,2064,z,1
212019,10,5,2,18,20,f,Jackie.jpg,pieFS5.bmp,Jackie used her mother's social security number to open a credit card account.,1,reputation,164706,166650,1944,m,0
212019,11,5,2,18,20,m,Ben.jpg,pieFS5.bmp,Ben stole money from his mother's wallet.,1,reputation,178751,180843,2092,m,0
212019,12,2,3,4,7,f,Fiona.jpg,pieFS2.bmp,Fiona just won the lottery,1,resources,192947,194774,1827,z,1
212019,13,2,6,9,15,m,Justin.jpg,pieFS2.bmp,Justin is a well paid lawyer,1,resources,206842,208911,2069,z,1
212019,14,1,8,8,16,m,Saul.jpg,pieFS1.bmp,Saul lost his life savings when his small business failed,2,na,221022,223292,2270,z,1
212019,15,3,2,4,6,f,Louise.jpg,pieFS3.bmp,Louise cannot afford to send her son to college.,2,na,235385,236548,1163,z,1
212019,16,4,3,12,15,f,Maria.jpg,pieFS4.bmp,Maria is raising money to buy gifts for children in need.,2,na,248645,249879,1234,z,1
212019,17,4,1,4,5,m,Darnell.jpg,pieFS4.bmp,Darnell cheated on his taxes and is now under investigation for tax fraud.,1,reputation,261971,264184,2213,m,0
212019,18,4,3,12,15,m,Brad.jpg,pieFS4.bmp,Brad is a veteran having trouble finding employment.,2,na,276284,277496,1212,z,1
212019,19,3,4,9,13,m,Sam.jpg,pieFS3.bmp,Sam stole his elderly father's prescription medications.,1,reputation,289594,291146,1552,m,0
212019,20,3,5,11,16,m,Taymar.jpg,pieFS3.bmp,Taymar is a retiree,2,na,303238,304458,1220,z,1
212019,21,1,5,5,10,f,Kelly.jpg,pieFS1.bmp,Kelly illegally parks in the disabled parking spots when she can.,1,reputation,316548,318687,2139,z,1
212019,22,5,1,9,10,m,Kevin.jpg,pieFS5.bmp,Kevin declared bankruptcy after he was laid off.,2,na,330778,333688,2910,z,1
212019,23,3,2,4,6,f,Sammy.jpg,pieFS3.bmp,Sammy's car with her bag and credit cards was recently stolen.,2,na,345776,348069,2293,z,1
212019,24,5,2,18,20,m,Matt.jpg,pieFS5.bmp,Matt takes valuables from his friends' homes when asked to house-sit.,1,reputation,360156,361381,1225,m,0
212019,25,5,1,9,10,m,Jack.jpg,pieFS5.bmp,Jack was injured in a hit-and-run accident and cannot afford his medical bills.,2,na,373466,375481,2015,z,1
212019,26,3,4,9,13,m,Edward.jpg,pieFS3.bmp,Edward just bought an expensive sports car,1,resources,387579,389280,1701,z,1
212019,27,2,3,4,7,m,Ricky.jpg,pieFS2.bmp,Ricky is saving for his son's operation,2,na,401373,403398,2025,z,1
212019,28,5,1,9,10,f,Cindy.jpg,pieFS5.bmp,Cindy just found out that her husband has incurred a large credit card debt.,2,na,415486,418341,2855,z,1
212019,29,2,6,9,15,m,Ian.jpg,pieFS2.bmp,Ian was mugged and had his wallet stolen.,2,na,430418,432216,1798,z,1
212019,30,3,4,9,13,m,Don.jpg,pieFS3.bmp,Don often goes through and steals the neighbors' mail.,1,reputation,444313,446690,2377,m,0
212019,31,1,9,9,18,m,Paul.jpg,pieFS1.bmp,Paul bullies his employees to put in extra hours at work.,1,reputation,458776,460190,1414,m,0
212019,32,2,8,12,20,f,Fay.jpg,pieFS2.bmp,Fay regularly fires employees to avoid promoting them.,1,reputation,472287,473522,1235,m,0
212019,33,4,4,16,20,f,Emily.jpg,pieFS4.bmp,Emily is a highly paid actress,1,resources,485596,487158,1562,z,1
212019,34,5,1,9,10,f,Emma.jpg,pieFS5.bmp,Emma secretly gambles with her husband's savings.,1,reputation,499257,500520,1263,m,0
212019,35,3,6,14,20,m,Mark.jpg,pieFS3.bmp,Mark has been unable to find a job for over a year.,2,na,512617,514394,1777,z,1
212019,36,3,5,11,16,f,Beth.jpg,pieFS3.bmp,Beth claims false expenses for her reportable work travel.,1,reputation,526479,527162,683,m,0
212019,37,4,4,16,20,m,Peter.jpg,pieFS4.bmp,Peter lost his house in a fire,2,na,539237,540474,1237,z,1
212019,38,5,1,9,10,f,Sharon.jpg,pieFS5.bmp,Sharon works as a cleaner in a hotel,2,na,552564,553730,1166,z,1
212019,39,4,1,4,5,f,Deborah.jpg,pieFS4.bmp,Deborah has to take an unpaid leave of absence because her mother broke her hip.,2,na,565823,567005,1182,z,1
212019,40,5,1,9,10,f,Trish.jpg,pieFS5.bmp,Trish's husband is a wealthy investment banker,1,resources,579100,581123,2023,z,1
212019,41,5,2,18,20,m,George.jpg,pieFS5.bmp,George just lost his job,2,na,593195,595654,2459,z,1
212019,42,5,1,9,10,f,Mary.jpg,pieFS5.bmp,Mary can't afford to pay her medical bills,2,na,607743,609305,1562,z,1
212019,43,3,3,7,10,f,Kay.jpg,pieFS3.bmp,Kay is going to be evicted because she is behind on her rent,2,na,621404,623159,1755,z,1
212019,44,4,2,8,10,m,Daniel.jpg,pieFS4.bmp,Daniel employs illegal immigrants and pays them less than minimum wage.,1,reputation,635249,636940,1691,m,0
212019,45,3,2,4,6,f,Arianna.jpg,pieFS3.bmp,Arianna owns an international company,1,resources,649027,649839,812,z,1
212019,46,4,4,16,20,f,Janet.jpg,pieFS4.bmp,Janet received a large inheritance from a distant relative,1,resources,661935,663751,1816,z,1
212019,47,4,3,12,15,f,Lauren.jpg,pieFS4.bmp,Lauren got a large cash bonus from her boss,1,resources,675847,676793,946,z,1
212019,48,2,7,10,17,f,Monica.jpg,pieFS2.bmp,Monica was a victim of identity theft and is now thousands of dollars in debt.,2,na,688889,690881,1992,z,1
212019,49,5,2,18,20,m,Alan.jpg,pieFS5.bmp,Alan could not afford his mortgage and his home was foreclosed.,2,na,702968,704662,1694,z,1
212019,50,1,10,10,20,f,Joanna.jpg,pieFS1.bmp,Joanna works two waitressing jobs to pay her bills.,2,na,716763,718713,1950,z,1
212019,51,3,3,7,10,m,Michael.jpg,pieFS3.bmp,Michael just found $50 on the street,1,resources,730808,732464,1656,z,1
212019,52,5,1,9,10,f,Marny.jpg,pieFS5.bmp,Marny just received a huge cash settlement,1,resources,744536,746098,1562,z,1
212179,1,5,1,9,10,m,Sam.jpg,pieFS5.bmp,Sam is homeless,2,na,123240,128181,4941,p,0
212179,2,2,7,10,17,f,Joanna.jpg,pieFS2.bmp,Joanna's car with her bag and credit cards was recently stolen.,2,na,140388,142941,2553,q,1
212179,3,5,1,9,10,f,Jenny.jpg,pieFS5.bmp,Jenny just found out that her husband has incurred a large credit card debt.,2,na,155138,159261,4123,q,1
212179,4,1,5,5,10,f,Fiona.jpg,pieFS1.bmp,Fiona secretly gambles with her husband's savings.,1,reputation,171453,173781,2328,q,1
212179,5,5,1,9,10,f,Kay.jpg,pieFS5.bmp,Kay claims false expenses for her reportable work travel.,1,reputation,185970,191281,5311,p,0
212179,6,1,10,10,20,f,Arianna.jpg,pieFS1.bmp,Arianna works as a cleaner in a hotel,2,na,203483,205541,2058,q,1
212179,7,4,1,4,5,m,Edward.jpg,pieFS4.bmp,Edward is hiding his taxable income in Switzerland.,1,reputation,217734,220541,2807,q,1
212179,8,2,6,9,15,m,Don.jpg,pieFS2.bmp,Don is saving to pay his university fees,2,na,232734,234901,2167,q,1
212179,9,3,3,7,10,m,Ricky.jpg,pieFS3.bmp,Ricky underreports his company's earnings and pockets the profits.,1,reputation,247101,249521,2420,q,1
212179,10,5,2,18,20,m,Ian.jpg,pieFS5.bmp,Ian lives in a luxury penthouse apartment,1,resources,261718,265221,3503,p,0
212179,11,4,3,12,15,m,Nick.jpg,pieFS4.bmp,Nick stole money from his mother's wallet.,1,reputation,277417,279642,2225,q,1
212179,12,2,8,12,20,f,Eileen.jpg,pieFS2.bmp,Eileen is a highly paid actress,1,resources,291834,293802,1968,q,1
212179,13,3,4,9,13,m,Alan.jpg,pieFS3.bmp,Alan is a well paid lawyer,1,resources,306001,307862,1861,q,1
212179,14,4,4,16,20,m,Tony.jpg,pieFS4.bmp,Tony lost his life savings when his small business failed,2,na,320052,322042,1990,q,1
212179,15,4,3,12,15,f,Trish.jpg,pieFS4.bmp,Trish's husband is a wealthy investment banker,1,resources,334236,337802,3566,q,1
212179,16,5,1,9,10,f,Jean.jpg,pieFS5.bmp,Jean has to take an unpaid leave of absence because her mother broke her hip.,2,na,350002,352622,2620,p,0
212179,17,4,1,4,5,m,George.jpg,pieFS4.bmp,George is a retiree,2,na,364819,367042,2223,p,0
212179,18,5,1,9,10,f,Marny.jpg,pieFS5.bmp,Marny got a large cash bonus from her boss,1,resources,379236,382102,2866,q,1
212179,19,4,2,8,10,f,Miriam.jpg,pieFS4.bmp,Miriam can't afford to pay her medical bills,2,na,394302,396702,2400,q,1
212179,20,4,3,12,15,f,Sharon.jpg,pieFS4.bmp,Sharon is going to be evicted because she is behind on her rent,2,na,408902,412142,3240,q,1
212179,21,4,2,8,10,m,Joe.jpg,pieFS4.bmp,Joe just bought an expensive sports car,1,resources,424335,426902,2567,p,0
212179,22,4,3,12,15,m,Justin.jpg,pieFS4.bmp,Justin is saving for his son's operation,2,na,439102,442142,3040,q,1
212179,23,3,4,9,13,m,Mark.jpg,pieFS3.bmp,Mark cheated on his taxes and is now under investigation for tax fraud.,1,reputation,454335,456442,2107,q,1
212179,24,5,1,9,10,f,Maria.jpg,pieFS5.bmp,Maria was a victim of identity theft and is now thousands of dollars in debt.,2,na,468635,471682,3047,p,0
212179,25,2,6,9,15,m,Paul.jpg,pieFS2.bmp,Paul bullies his employees to put in extra hours at work.,1,reputation,483885,485862,1977,q,1
212179,26,1,8,8,16,m,Jared.jpg,pieFS1.bmp,Jared just lost his job,2,na,498052,499782,1730,q,1
212179,27,4,4,16,20,f,Beth.jpg,pieFS4.bmp,Beth owns an international company,1,resources,511986,514762,2776,q,1
212179,28,4,1,4,5,f,Kelly.jpg,pieFS4.bmp,Kelly works two waitressing jobs to pay her bills.,2,na,526953,529662,2709,p,0
212179,29,5,2,18,20,f,Emma.jpg,pieFS5.bmp,Emma received a large inheritance from a distant relative,1,resources,541853,544023,2170,p,0
212179,30,4,4,16,20,f,Monica.jpg,pieFS4.bmp,Monica just received a huge cash settlement,1,resources,556220,558303,2083,q,1
212179,31,5,2,18,20,m,Matt.jpg,pieFS5.bmp,Matt is a veteran having trouble finding employment.,2,na,570504,572803,2299,p,0
212179,32,4,2,8,10,m,Ben.jpg,pieFS4.bmp,Ben stole his elderly father's prescription medications.,1,reputation,584988,588103,3115,q,1
212179,33,4,2,8,10,f,Lauren.jpg,pieFS4.bmp,Lauren takes discarded food from grocery stores to feed her children.,2,na,600304,603143,2839,q,1
212179,34,3,3,7,10,f,Fay.jpg,pieFS3.bmp,Fay is a single mother,2,na,615337,617763,2426,q,1
212179,35,2,3,4,7,f,Sammy.jpg,pieFS2.bmp,Sammy steals her coworkers' tips to buy alcohol.,1,reputation,629954,632023,2069,p,0
212179,36,5,1,9,10,m,Stuart.jpg,pieFS5.bmp,Stuart declared bankruptcy after he was laid off.,2,na,644221,647603,3382,p,0
212179,37,5,1,9,10,m,Peter.jpg,pieFS5.bmp,Peter takes valuables from his friends' homes when asked to house-sit.,1,reputation,659803,662203,2400,p,0
212179,38,3,2,4,6,f,Jackie.jpg,pieFS3.bmp,Jackie just lost her small business after a franchise moved in next door.,2,na,674404,676683,2279,q,1
212179,39,5,2,18,20,m,Saul.jpg,pieFS5.bmp,Saul was injured in a hit-and-run accident and cannot afford his medical bills.,2,na,688887,692083,3196,p,0
212179,40,5,1,9,10,f,Mary.jpg,pieFS5.bmp,Mary just won the lottery,1,resources,704287,706263,1976,p,0
212179,41,3,6,14,20,m,Brad.jpg,pieFS3.bmp,Brad was mugged and had his wallet stolen.,2,na,718454,720503,2049,q,1
212179,42,3,2,4,6,f,Janet.jpg,pieFS3.bmp,Janet cannot afford to send her son to college.,2,na,732705,734963,2258,q,1
212179,43,5,2,18,20,m,Jack.jpg,pieFS5.bmp,Jack often goes through and steals the neighbors' mail.,1,reputation,747155,750363,3208,p,0
212179,44,3,5,11,16,m,Kevin.jpg,pieFS3.bmp,Kevin has been unable to find a job for over a year.,2,na,762555,764763,2208,q,1
212179,45,3,6,14,20,m,Michael.jpg,pieFS3.bmp,Michael lost his house in a fire,2,na,776955,778943,1988,q,1
212179,46,3,2,4,6,f,Louise.jpg,pieFS3.bmp,Louise regularly fires employees to avoid promoting them.,1,reputation,791123,793903,2780,p,0
212179,47,3,5,11,16,f,Deborah.jpg,pieFS3.bmp,Deborah used her mother's social security number to open a credit card account.,1,reputation,806106,808103,1997,q,1
212179,48,3,4,9,13,m,Taymar.jpg,pieFS3.bmp,Taymar employs illegal immigrants and pays them less than minimum wage.,1,reputation,820306,822303,1997,q,1
212179,49,1,9,9,18,m,Darnell.jpg,pieFS1.bmp,Darnell just found $50 on the street,1,resources,834507,836584,2077,q,1
212179,50,3,2,4,6,f,Emily.jpg,pieFS3.bmp,Emily is raising money to buy gifts for children in need.,2,na,848774,850724,1950,q,1
212179,51,2,3,4,7,m,Daniel.jpg,pieFS2.bmp,Daniel could not afford his mortgage and his home was foreclosed.,2,na,862925,865384,2459,q,1
212179,52,3,3,7,10,f,Cindy.jpg,pieFS3.bmp,Cindy illegally parks in the disabled parking spots when she can.,1,reputation,877575,879784,2209,q,1
212556,1,5,2,18,20,m,Jack.jpg,pieFS5.bmp,Jack stole money from his mother's wallet.,1,reputation,33408,37398,3990,m,0
212556,2,2,6,9,15,m,Saul.jpg,pieFS2.bmp,Saul lost his life savings when his small business failed,2,na,49510,52336,2826,z,1
212556,3,5,2,18,20,m,George.jpg,pieFS5.bmp,George underreports his company's earnings and pockets the profits.,1,reputation,64425,67284,2859,m,0
212556,4,4,4,16,20,f,Emma.jpg,pieFS4.bmp,Emma's husband is a wealthy investment banker,1,resources,79391,80333,942,m,0
212556,5,4,1,4,5,m,Matt.jpg,pieFS4.bmp,Matt cheated on his taxes and is now under investigation for tax fraud.,1,reputation,92433,100358,7925,m,0
212556,6,3,3,7,10,m,Ricky.jpg,pieFS3.bmp,Ricky is a well paid lawyer,1,resources,112464,114190,1726,z,1
212556,7,1,10,10,20,f,Miriam.jpg,pieFS1.bmp,Miriam can't afford to pay her medical bills,2,na,126293,129364,3071,z,1
212556,8,5,2,18,20,m,Don.jpg,pieFS5.bmp,Don is a veteran having trouble finding employment.,2,na,141459,145094,3635,z,1
212556,9,4,1,4,5,m,Taymar.jpg,pieFS4.bmp,Taymar is a retiree,2,na,157176,162043,4867,m,0
212556,10,4,2,8,10,f,Arianna.jpg,pieFS4.bmp,Arianna is going to be evicted because she is behind on her rent,2,na,174131,178974,4843,m,0
212556,11,3,4,9,13,m,Joe.jpg,pieFS3.bmp,Joe just bought an expensive sports car,1,resources,191069,199992,8923,m,0
212556,12,1,8,8,16,m,Daniel.jpg,pieFS1.bmp,Daniel is saving for his son's operation,2,na,212088,216754,4666,z,1
212556,13,4,2,8,10,m,Stuart.jpg,pieFS4.bmp,Stuart stole his elderly father's prescription medications.,1,reputation,228842,232086,3244,m,0
212556,14,4,1,4,5,f,Marny.jpg,pieFS4.bmp,Marny just found out that her husband has incurred a large credit card debt.,2,na,244175,248722,4547,m,0
212556,15,3,3,7,10,f,Joanna.jpg,pieFS3.bmp,Joanna is a highly paid actress,1,resources,260812,263440,2628,z,1
212556,16,4,4,16,20,m,Mark.jpg,pieFS4.bmp,Mark declared bankruptcy after he was laid off.,2,na,275527,280858,5331,z,1
212556,17,5,1,9,10,m,Tony.jpg,pieFS5.bmp,Tony takes valuables from his friends' homes when asked to house-sit.,1,reputation,292950,298557,5607,z,1
212556,18,1,5,5,10,f,Fay.jpg,pieFS1.bmp,Fay owns an international company,1,resources,310657,312919,2262,z,1
212556,19,4,2,8,10,m,Edward.jpg,pieFS4.bmp,Edward bullies his employees to put in extra hours at work.,1,reputation,325004,326494,1490,m,0
212556,20,5,1,9,10,f,Fiona.jpg,pieFS5.bmp,Fiona received a large inheritance from a distant relative,1,resources,338581,344694,6113,m,0
212556,21,4,3,12,15,m,Peter.jpg,pieFS4.bmp,Peter was injured in a hit-and-run accident and cannot afford his medical bills.,2,na,356807,360936,4129,z,1
212556,22,5,1,9,10,f,Cindy.jpg,pieFS5.bmp,Cindy has to take an unpaid leave of absence because her mother broke her hip.,2,na,373026,375617,2591,m,0
212556,23,2,3,4,7,f,Lauren.jpg,pieFS2.bmp,Lauren got a large cash bonus from her boss,1,resources,387707,392735,5028,z,1
212556,24,3,6,14,20,m,Brad.jpg,pieFS3.bmp,Brad was mugged and had his wallet stolen.,2,na,404829,415853,11024,z,1
212556,25,2,6,9,15,m,Sam.jpg,pieFS2.bmp,Sam often goes through and steals the neighbors' mail.,1,reputation,427938,431790,3852,m,0
212556,26,5,1,9,10,m,Darnell.jpg,pieFS5.bmp,Darnell has been unable to find a job for over a year.,2,na,443889,449002,5113,m,0
212556,27,4,2,8,10,f,Trish.jpg,pieFS4.bmp,Trish is a single mother,2,na,461079,464934,3855,m,0
212556,28,5,2,18,20,m,Michael.jpg,pieFS5.bmp,Michael lost his house in a fire,2,na,477014,483088,6074,m,0
212556,29,4,3,12,15,f,Monica.jpg,pieFS4.bmp,Monica was a victim of identity theft and is now thousands of dollars in debt.,2,na,495172,503450,8278,z,1
212556,30,4,3,12,15,f,Sharon.jpg,pieFS4.bmp,Sharon just won the lottery,1,resources,515538,519387,3849,z,1
212556,31,3,2,4,6,f,Beth.jpg,pieFS3.bmp,Beth cannot afford to send her son to college.,2,na,531473,535643,4170,z,1
212556,32,3,2,4,6,f,Kelly.jpg,pieFS3.bmp,Kelly works two waitressing jobs to pay her bills.,2,na,547743,552517,4774,z,1
212556,33,5,2,18,20,f,Sammy.jpg,pieFS5.bmp,Sammy just received a huge cash settlement,1,resources,564614,571191,6577,z,1
212556,34,3,5,11,16,f,Kay.jpg,pieFS3.bmp,Kay regularly fires employees to avoid promoting them.,1,reputation,583292,586242,2950,m,0
212556,35,4,3,12,15,m,Nick.jpg,pieFS4.bmp,Nick just found $50 on the street,1,resources,598340,601958,3618,m,0
212556,36,5,1,9,10,m,Alan.jpg,pieFS5.bmp,Alan just lost his job,2,na,614041,616602,2561,m,0
212556,37,5,1,9,10,f,Deborah.jpg,pieFS5.bmp,Deborah takes discarded food from grocery stores to feed her children.,2,na,628689,633289,4600,m,0
212556,38,2,8,12,20,f,Janet.jpg,pieFS2.bmp,Janet secretly gambles with her husband's savings.,1,reputation,645360,655183,9823,m,0
212556,39,5,1,9,10,f,Emily.jpg,pieFS5.bmp,Emily steals her coworkers' tips to buy alcohol.,1,reputation,667281,669550,2269,m,0
212556,40,1,9,9,18,m,Paul.jpg,pieFS1.bmp,Paul employs illegal immigrants and pays them less than minimum wage.,1,reputation,681644,686476,4832,z,1
212556,41,3,3,7,10,f,Jean.jpg,pieFS3.bmp,Jean just lost her small business after a franchise moved in next door.,2,na,698565,705809,7244,z,1
212556,42,2,3,4,7,m,Ben.jpg,pieFS2.bmp,Ben is homeless,2,na,717895,720773,2878,m,0
212556,43,5,1,9,10,f,Jenny.jpg,pieFS5.bmp,Jenny used her mother's social security number to open a credit card account.,1,reputation,732860,734347,1487,m,0
212556,44,3,5,11,16,m,Justin.jpg,pieFS3.bmp,Justin could not afford his mortgage and his home was foreclosed.,2,na,746437,752141,5704,m,0
212556,45,3,2,4,6,f,Eileen.jpg,pieFS3.bmp,Eileen is raising money to buy gifts for children in need.,2,na,764228,765898,1670,z,1
212556,46,3,2,4,6,f,Maria.jpg,pieFS3.bmp,Maria illegally parks in the disabled parking spots when she can.,1,reputation,777990,780940,2950,m,0
212556,47,3,6,14,20,m,Ian.jpg,pieFS3.bmp,Ian is saving to pay his university fees,2,na,793055,794472,1417,m,0
212556,48,3,4,9,13,m,Jared.jpg,pieFS3.bmp,Jared is hiding his taxable income in Switzerland.,1,reputation,806566,807826,1260,m,0
212556,49,4,4,16,20,f,Mary.jpg,pieFS4.bmp,Mary claims false expenses for her reportable work travel.,1,reputation,819926,822000,2074,z,1
212556,50,5,1,9,10,f,Jackie.jpg,pieFS5.bmp,Jackie's car with her bag and credit cards was recently stolen.,2,na,834088,836888,2800,m,0
212556,51,2,7,10,17,f,Louise.jpg,pieFS2.bmp,Louise works as a cleaner in a hotel,2,na,848987,851381,2394,z,1
212556,52,3,4,9,13,m,Kevin.jpg,pieFS3.bmp,Kevin lives in a luxury penthouse apartment,1,resources,863467,866305,2838,z,1
212794,1,1,9,9,18,m,Sam.jpg,pieFS1.bmp,Sam stole his elderly father's prescription medications.,1,reputation,31672,35186,3514,m,0
212794,2,3,2,4,6,f,Trish.jpg,pieFS3.bmp,Trish's husband is a wealthy investment banker,1,resources,47289,48704,1415,z,1
212794,3,1,8,8,16,m,Justin.jpg,pieFS1.bmp,Justin is saving for his son's operation,2,na,60783,62311,1528,z,1
212794,4,3,5,11,16,m,Kevin.jpg,pieFS3.bmp,Kevin declared bankruptcy after he was laid off.,2,na,74411,76210,1799,z,1
212794,5,4,3,12,15,f,Maria.jpg,pieFS4.bmp,Maria illegally parks in the disabled parking spots when she can.,1,reputation,88323,90459,2136,m,0
212794,6,3,2,4,6,f,Jenny.jpg,pieFS3.bmp,Jenny's car with her bag and credit cards was recently stolen.,2,na,102552,104202,1650,z,1
212794,7,3,4,9,13,m,Nick.jpg,pieFS3.bmp,Nick takes valuables from his friends' homes when asked to house-sit.,1,reputation,116297,117571,1274,z,1
212794,8,4,1,4,5,f,Kay.jpg,pieFS4.bmp,Kay can't afford to pay her medical bills,2,na,129657,131389,1732,z,1
212794,9,3,3,7,10,f,Janet.jpg,pieFS3.bmp,Janet is going to be evicted because she is behind on her rent,2,na,143485,144720,1235,z,1
212794,10,4,2,8,10,m,Jared.jpg,pieFS4.bmp,Jared bullies his employees to put in extra hours at work.,1,reputation,156811,158613,1802,m,0
212794,11,4,3,12,15,m,Brad.jpg,pieFS4.bmp,Brad was injured in a hit-and-run accident and cannot afford his medical bills.,2,na,170706,172225,1519,z,1
212794,12,1,5,5,10,f,Beth.jpg,pieFS1.bmp,Beth owns an international company,1,resources,184300,186099,1799,z,1
212794,13,3,6,14,20,m,Alan.jpg,pieFS3.bmp,Alan just lost his job,2,na,198196,199805,1609,z,1
212794,14,5,1,9,10,f,Miriam.jpg,pieFS5.bmp,Miriam received a large inheritance from a distant relative,1,resources,211907,213955,2048,m,0
212794,15,5,2,18,20,m,George.jpg,pieFS5.bmp,George employs illegal immigrants and pays them less than minimum wage.,1,reputation,226053,227292,1239,m,0
212794,16,4,4,16,20,m,Ian.jpg,pieFS4.bmp,Ian was mugged and had his wallet stolen.,2,na,239362,241185,1823,z,1
212794,17,3,6,14,20,m,Daniel.jpg,pieFS3.bmp,Daniel could not afford his mortgage and his home was foreclosed.,2,na,253274,255051,1777,z,1
212794,18,4,1,4,5,m,Taymar.jpg,pieFS4.bmp,Taymar is hiding his taxable income in Switzerland.,1,reputation,267136,268653,1517,m,0
212794,19,3,3,7,10,m,Don.jpg,pieFS3.bmp,Don often goes through and steals the neighbors' mail.,1,reputation,280747,281983,1236,m,0
212794,20,5,1,9,10,f,Sharon.jpg,pieFS5.bmp,Sharon is a single mother,2,na,294056,295614,1558,z,1
212794,21,4,2,8,10,f,Joanna.jpg,pieFS4.bmp,Joanna just found out that her husband has incurred a large credit card debt.,2,na,307701,309245,1544,z,1
212794,22,5,2,18,20,m,Jack.jpg,pieFS5.bmp,Jack has been unable to find a job for over a year.,2,na,321345,322707,1362,z,1
212794,23,2,3,4,7,f,Emma.jpg,pieFS2.bmp,Emma just won the lottery,1,resources,334822,336563,1741,z,1
212794,24,3,3,7,10,f,Jean.jpg,pieFS3.bmp,Jean is a highly paid actress,1,resources,348633,350268,1635,z,1
212794,25,5,1,9,10,m,Saul.jpg,pieFS5.bmp,Saul lost his house in a fire,2,na,362361,363787,1426,z,1
212794,26,3,2,4,6,f,Fiona.jpg,pieFS3.bmp,Fiona cannot afford to send her son to college.,2,na,375872,377549,1677,z,1
212794,27,4,2,8,10,m,Stuart.jpg,pieFS4.bmp,Stuart just found $50 on the street,1,resources,389616,391086,1470,z,1
212794,28,2,6,9,15,m,Paul.jpg,pieFS2.bmp,Paul underreports his company's earnings and pockets the profits.,1,reputation,403177,404867,1690,m,0
212794,29,5,1,9,10,f,Fay.jpg,pieFS5.bmp,Fay regularly fires employees to avoid promoting them.,1,reputation,416938,418513,1575,m,0
212794,30,3,2,4,6,f,Monica.jpg,pieFS3.bmp,Monica has to take an unpaid leave of absence because her mother broke her hip.,2,na,430599,432466,1867,z,1
212794,31,5,1,9,10,m,Ben.jpg,pieFS5.bmp,Ben is homeless,2,na,444561,446003,1442,z,1
212794,32,2,8,12,20,f,Marny.jpg,pieFS2.bmp,Marny got a large cash bonus from her boss,1,resources,458088,459633,1545,z,1
212794,33,2,3,4,7,m,Matt.jpg,pieFS2.bmp,Matt is saving to pay his university fees,2,na,471733,472983,1250,z,1
212794,34,4,3,12,15,m,Peter.jpg,pieFS4.bmp,Peter lives in a luxury penthouse apartment,1,resources,485059,486951,1892,z,1
212794,35,4,2,8,10,f,Emily.jpg,pieFS4.bmp,Emily was a victim of identity theft and is now thousands of dollars in debt.,2,na,499038,500767,1729,z,1
212794,36,5,1,9,10,f,Deborah.jpg,pieFS5.bmp,Deborah works two waitressing jobs to pay her bills.,2,na,512849,514325,1476,z,1
212794,37,3,5,11,16,f,Cindy.jpg,pieFS3.bmp,Cindy just received a huge cash settlement,1,resources,526393,528162,1769,z,1
212794,38,3,4,9,13,m,Darnell.jpg,pieFS3.bmp,Darnell stole money from his mother's wallet.,1,reputation,540255,542055,1800,m,0
212794,39,4,3,12,15,f,Kelly.jpg,pieFS4.bmp,Kelly takes discarded food from grocery stores to feed her children.,2,na,554150,555949,1799,z,1
212794,40,5,2,18,20,m,Michael.jpg,pieFS5.bmp,Michael lost his life savings when his small business failed,2,na,568045,569318,1273,z,1
212794,41,5,2,18,20,m,Tony.jpg,pieFS5.bmp,Tony cheated on his taxes and is now under investigation for tax fraud.,1,reputation,581405,583100,1695,m,0
212794,42,5,2,18,20,f,Eileen.jpg,pieFS5.bmp,Eileen steals her coworkers' tips to buy alcohol.,1,reputation,595200,598078,2878,m,0
212794,43,5,1,9,10,m,Joe.jpg,pieFS5.bmp,Joe is a well paid lawyer,1,resources,610148,612347,2199,z,1
212794,44,2,7,10,17,f,Jackie.jpg,pieFS2.bmp,Jackie just lost her small business after a franchise moved in next door.,2,na,624445,626274,1829,z,1
212794,45,4,4,16,20,f,Arianna.jpg,pieFS4.bmp,Arianna secretly gambles with her husband's savings.,1,reputation,638356,640246,1890,m,0
212794,46,2,6,9,15,m,Ricky.jpg,pieFS2.bmp,Ricky is a retiree,2,na,652318,653666,1348,z,1
212794,47,4,4,16,20,f,Mary.jpg,pieFS4.bmp,Mary claims false expenses for her reportable work travel.,1,reputation,665762,667166,1404,m,0
212794,48,4,1,4,5,m,Mark.jpg,pieFS4.bmp,Mark is a veteran having trouble finding employment.,2,na,679256,680425,1169,z,1
212794,49,1,10,10,20,f,Louise.jpg,pieFS1.bmp,Louise works as a cleaner in a hotel,2,na,692515,693962,1447,z,1
212794,50,3,4,9,13,m,Edward.jpg,pieFS3.bmp,Edward just bought an expensive sports car,1,resources,706059,707543,1484,z,1
212794,51,5,1,9,10,f,Lauren.jpg,pieFS5.bmp,Lauren used her mother's social security number to open a credit card account.,1,reputation,719637,720380,743,m,0
212794,52,5,1,9,10,f,Sammy.jpg,pieFS5.bmp,Sammy is raising money to buy gifts for children in need.,2,na,732478,733711,1233,z,1
212856,1,3,6,14,20,m,Justin.jpg,pieFS3.bmp,Justin just lost his job,2,na,40554,44571,4017,q,1
212856,2,1,9,9,18,m,Kevin.jpg,pieFS1.bmp,Kevin cheated on his taxes and is now under investigation for tax fraud.,1,reputation,56752,61051,4299,q,1
212856,3,5,2,18,20,m,Alan.jpg,pieFS5.bmp,Alan employs illegal immigrants and pays them less than minimum wage.,1,reputation,73234,79911,6677,q,1
212856,4,4,3,12,15,m,Stuart.jpg,pieFS4.bmp,Stuart is a veteran having trouble finding employment.,2,na,92086,94751,2665,q,1
212856,5,2,6,9,15,m,Edward.jpg,pieFS2.bmp,Edward could not afford his mortgage and his home was foreclosed.,2,na,106930,109031,2101,q,1
212856,6,5,1,9,10,f,Eileen.jpg,pieFS5.bmp,Eileen was a victim of identity theft and is now thousands of dollars in debt.,2,na,121197,123312,2115,q,1
212856,7,3,4,9,13,m,Sam.jpg,pieFS3.bmp,Sam stole his elderly father's prescription medications.,1,reputation,135481,139592,4111,q,1
212856,8,3,5,11,16,m,Brad.jpg,pieFS3.bmp,Brad declared bankruptcy after he was laid off.,2,na,151763,153672,1909,q,1
212856,9,5,1,9,10,m,Joe.jpg,pieFS5.bmp,Joe is hiding his taxable income in Switzerland.,1,reputation,165847,169132,3285,q,1
212856,10,3,4,9,13,m,Nick.jpg,pieFS3.bmp,Nick takes valuables from his friends' homes when asked to house-sit.,1,reputation,181296,183152,1856,q,1
212856,11,5,1,9,10,m,Jack.jpg,pieFS5.bmp,Jack was injured in a hit-and-run accident and cannot afford his medical bills.,2,na,195331,197532,2201,q,1
212856,12,2,7,10,17,f,Fiona.jpg,pieFS2.bmp,Fiona is going to be evicted because she is behind on her rent,2,na,209681,211332,1651,q,1
212856,13,5,1,9,10,f,Arianna.jpg,pieFS5.bmp,Arianna owns an international company,1,resources,223483,226173,2690,q,1
212856,14,3,4,9,13,m,Paul.jpg,pieFS3.bmp,Paul underreports his company's earnings and pockets the profits.,1,reputation,238333,242633,4300,q,1
212856,15,3,2,4,6,f,Sammy.jpg,pieFS3.bmp,Sammy works two waitressing jobs to pay her bills.,2,na,254781,257593,2812,q,1
212856,16,3,2,4,6,f,Jackie.jpg,pieFS3.bmp,Jackie just received a huge cash settlement,1,resources,269748,271453,1705,q,1
212856,17,2,8,12,20,f,Emma.jpg,pieFS2.bmp,Emma received a large inheritance from a distant relative,1,resources,283599,285493,1894,q,1
212856,18,4,2,8,10,m,Daniel.jpg,pieFS4.bmp,Daniel is a well paid lawyer,1,resources,297650,299813,2163,q,1
212856,19,5,1,9,10,m,George.jpg,pieFS5.bmp,George is a retiree,2,na,311967,313494,1527,q,1
212856,20,5,1,9,10,f,Beth.jpg,pieFS5.bmp,Beth is a single mother,2,na,325652,328454,2802,q,1
212856,21,5,2,18,20,m,Mark.jpg,pieFS5.bmp,Mark was mugged and had his wallet stolen.,2,na,340602,342194,1592,q,1
212856,22,3,3,7,10,f,Mary.jpg,pieFS3.bmp,Mary just won the lottery,1,resources,354353,356814,2461,q,1
212856,23,5,1,9,10,f,Monica.jpg,pieFS5.bmp,Monica takes discarded food from grocery stores to feed her children.,2,na,368987,371534,2547,q,1
212856,24,4,3,12,15,f,Jenny.jpg,pieFS4.bmp,Jenny steals her coworkers' tips to buy alcohol.,1,reputation,383704,387094,3390,q,1
212856,25,4,3,12,15,f,Miriam.jpg,pieFS4.bmp,Miriam cannot afford to send her son to college.,2,na,399270,401354,2084,q,1
212856,26,4,4,16,20,f,Sharon.jpg,pieFS4.bmp,Sharon regularly fires employees to avoid promoting them.,1,reputation,413520,417975,4455,q,1
212856,27,4,2,8,10,f,Lauren.jpg,pieFS4.bmp,Lauren just lost her small business after a franchise moved in next door.,2,na,430152,431835,1683,q,1
212856,28,5,2,18,20,f,Kelly.jpg,pieFS5.bmp,Kelly used her mother's social security number to open a credit card account.,1,reputation,444003,448775,4772,q,1
212856,29,4,1,4,5,m,Ricky.jpg,pieFS4.bmp,Ricky just bought an expensive sports car,1,resources,460934,463655,2721,q,1
212856,30,2,3,4,7,f,Janet.jpg,pieFS2.bmp,Janet secretly gambles with her husband's savings.,1,reputation,475801,479315,3514,q,1
212856,31,1,5,5,10,f,Trish.jpg,pieFS1.bmp,Trish claims false expenses for her reportable work travel.,1,reputation,491466,493795,2329,q,1
212856,32,4,2,8,10,f,Kay.jpg,pieFS4.bmp,Kay works as a cleaner in a hotel,2,na,505950,510355,4405,q,1
212856,33,4,1,4,5,m,Jared.jpg,pieFS4.bmp,Jared is saving for his son's operation,2,na,522515,524396,1881,q,1
212856,34,3,2,4,6,f,Emily.jpg,pieFS3.bmp,Emily is raising money to buy gifts for children in need.,2,na,536549,537916,1367,q,1
212856,35,5,2,18,20,m,Saul.jpg,pieFS5.bmp,Saul often goes through and steals the neighbors' mail.,1,reputation,550068,554916,4848,q,1
212856,36,4,4,16,20,f,Marny.jpg,pieFS4.bmp,Marny illegally parks in the disabled parking spots when she can.,1,reputation,567082,569956,2874,q,1
212856,37,5,1,9,10,f,Fay.jpg,pieFS5.bmp,Fay's husband is a wealthy investment banker,1,resources,582115,584376,2261,q,1
212856,38,5,2,18,20,m,Darnell.jpg,pieFS5.bmp,Darnell has been unable to find a job for over a year.,2,na,596532,599157,2625,q,1
212856,39,1,8,8,16,m,Ian.jpg,pieFS1.bmp,Ian lost his house in a fire,2,na,611316,614457,3141,q,1
212856,40,4,2,8,10,m,Michael.jpg,pieFS4.bmp,Michael just found $50 on the street,1,resources,626615,628457,1842,q,1
212856,41,4,1,4,5,f,Maria.jpg,pieFS4.bmp,Maria's car with her bag and credit cards was recently stolen.,2,na,640616,644857,4241,q,1
212856,42,1,10,10,20,f,Deborah.jpg,pieFS1.bmp,Deborah just found out that her husband has incurred a large credit card debt.,2,na,657031,660377,3346,q,1
212856,43,3,2,4,6,f,Louise.jpg,pieFS3.bmp,Louise can't afford to pay her medical bills,2,na,672531,673877,1346,q,1
212856,44,2,6,9,15,m,Taymar.jpg,pieFS2.bmp,Taymar bullies his employees to put in extra hours at work.,1,reputation,686049,688877,2828,q,1
212856,45,3,5,11,16,f,Joanna.jpg,pieFS3.bmp,Joanna is a highly paid actress,1,resources,701032,702258,1226,q,1
212856,46,3,3,7,10,f,Cindy.jpg,pieFS3.bmp,Cindy has to take an unpaid leave of absence because her mother broke her hip.,2,na,714434,715818,1384,q,1
212856,47,3,6,14,20,m,Peter.jpg,pieFS3.bmp,Peter is homeless,2,na,727969,730438,2469,q,1
212856,48,5,1,9,10,f,Jean.jpg,pieFS5.bmp,Jean got a large cash bonus from her boss,1,resources,742586,743938,1352,q,1
212856,49,4,4,16,20,m,Tony.jpg,pieFS4.bmp,Tony is saving to pay his university fees,2,na,756087,757978,1891,q,1
212856,50,4,3,12,15,m,Don.jpg,pieFS4.bmp,Don lives in a luxury penthouse apartment,1,resources,770138,771478,1340,q,1
212856,51,3,3,7,10,m,Ben.jpg,pieFS3.bmp,Ben stole money from his mother's wallet.,1,reputation,783640,785038,1398,q,1
212856,52,2,3,4,7,m,Matt.jpg,pieFS2.bmp,Matt lost his life savings when his small business failed,2,na,797208,799918,2710,q,1
212857,1,3,2,4,6,f,Lauren.jpg,pieFS3.bmp,Lauren works two waitressing jobs to pay her bills.,2,na,89848,92607,2759,q,1
212857,2,5,1,9,10,m,Ricky.jpg,pieFS5.bmp,Ricky employs illegal immigrants and pays them less than minimum wage.,1,reputation,104881,107348,2467,p,0
212857,3,3,6,14,20,m,Mark.jpg,pieFS3.bmp,Mark is a veteran having trouble finding employment.,2,na,119632,121388,1756,q,1
212857,4,4,4,16,20,f,Trish.jpg,pieFS4.bmp,Trish owns an international company,1,resources,133683,135449,1766,q,1
212857,5,3,4,9,13,m,Peter.jpg,pieFS3.bmp,Peter stole his elderly father's prescription medications.,1,reputation,147734,149369,1635,p,0
212857,6,3,5,11,16,m,Saul.jpg,pieFS3.bmp,Saul declared bankruptcy after he was laid off.,2,na,161668,163229,1561,q,1
212857,7,4,3,12,15,f,Louise.jpg,pieFS4.bmp,Louise received a large inheritance from a distant relative,1,resources,175520,177170,1650,q,1
212857,8,4,4,16,20,m,Edward.jpg,pieFS4.bmp,Edward could not afford his mortgage and his home was foreclosed.,2,na,189405,190970,1565,q,1
212857,9,2,8,12,20,f,Marny.jpg,pieFS2.bmp,Marny just received a huge cash settlement,1,resources,203223,205070,1847,q,1
212857,10,4,2,8,10,f,Sharon.jpg,pieFS4.bmp,Sharon is a single mother,2,na,217290,218931,1641,q,1
212857,11,4,1,4,5,m,Alan.jpg,pieFS4.bmp,Alan is hiding his taxable income in Switzerland.,1,reputation,231159,233171,2012,p,0
212857,12,3,5,11,16,f,Kay.jpg,pieFS3.bmp,Kay just won the lottery,1,resources,245393,246532,1139,q,1
212857,13,5,1,9,10,f,Cindy.jpg,pieFS5.bmp,Cindy takes discarded food from grocery stores to feed her children.,2,na,258761,259452,691,q,1
212857,14,4,2,8,10,m,Jared.jpg,pieFS4.bmp,Jared underreports his company's earnings and pockets the profits.,1,reputation,271681,273212,1531,p,0
212857,15,4,3,12,15,m,Brad.jpg,pieFS4.bmp,Brad takes valuables from his friends' homes when asked to house-sit.,1,reputation,285432,285953,521,p,0
212857,16,5,1,9,10,m,Jack.jpg,pieFS5.bmp,Jack was injured in a hit-and-run accident and cannot afford his medical bills.,2,na,298185,299293,1108,q,1
212857,17,5,1,9,10,f,Jenny.jpg,pieFS5.bmp,Jenny steals her coworkers' tips to buy alcohol.,1,reputation,311520,312253,733,p,0
212857,18,2,7,10,17,f,Arianna.jpg,pieFS2.bmp,Arianna cannot afford to send her son to college.,2,na,324489,325214,725,q,1
212857,19,3,2,4,6,f,Maria.jpg,pieFS3.bmp,Maria just lost her small business after a franchise moved in next door.,2,na,337441,338774,1333,q,1
212857,20,4,2,8,10,m,Paul.jpg,pieFS4.bmp,Paul is a well paid lawyer,1,resources,351026,352454,1428,q,1
212857,21,5,2,18,20,m,Nick.jpg,pieFS5.bmp,Nick was mugged and had his wallet stolen.,2,na,364728,365395,667,q,1
212857,22,1,5,5,10,f,Kelly.jpg,pieFS1.bmp,Kelly used her mother's social security number to open a credit card account.,1,reputation,377664,378395,731,p,0
212857,23,3,4,9,13,m,Ian.jpg,pieFS3.bmp,Ian often goes through and steals the neighbors' mail.,1,reputation,390666,391055,389,p,0
212857,24,4,1,4,5,m,Sam.jpg,pieFS4.bmp,Sam has been unable to find a job for over a year.,2,na,403335,404216,881,q,1
212857,25,1,8,8,16,m,Joe.jpg,pieFS1.bmp,Joe is a retiree,2,na,416454,418556,2102,q,1
212857,26,5,1,9,10,f,Mary.jpg,pieFS5.bmp,Mary regularly fires employees to avoid promoting them.,1,reputation,430805,431436,631,p,0
212857,27,4,1,4,5,f,Jackie.jpg,pieFS4.bmp,Jackie is raising money to buy gifts for children in need.,2,na,443674,444137,463,q,1
212857,28,3,3,7,10,f,Deborah.jpg,pieFS3.bmp,Deborah illegally parks in the disabled parking spots when she can.,1,reputation,456410,456877,467,p,0
212857,29,4,3,12,15,m,Darnell.jpg,pieFS4.bmp,Darnell lost his house in a fire,2,na,469130,470057,927,q,1
212857,30,5,2,18,20,f,Miriam.jpg,pieFS5.bmp,Miriam secretly gambles with her husband's savings.,1,reputation,482298,482798,500,p,0
212857,31,5,1,9,10,f,Joanna.jpg,pieFS5.bmp,Joanna's car with her bag and credit cards was recently stolen.,2,na,495034,496178,1144,q,1
212857,32,1,9,9,18,m,Justin.jpg,pieFS1.bmp,Justin just bought an expensive sports car,1,resources,508403,509758,1355,q,1
212857,33,5,1,9,10,f,Janet.jpg,pieFS5.bmp,Janet claims false expenses for her reportable work travel.,1,reputation,521988,523279,1291,q,1
212857,34,5,1,9,10,f,Emma.jpg,pieFS5.bmp,Emma works as a cleaner in a hotel,2,na,535506,536439,933,q,1
212857,35,5,2,18,20,m,Tony.jpg,pieFS5.bmp,Tony just found $50 on the street,1,resources,548659,550979,2320,q,1
212857,36,3,6,14,20,m,George.jpg,pieFS3.bmp,George is saving for his son's operation,2,na,563209,563780,571,q,1
212857,37,5,2,18,20,m,Daniel.jpg,pieFS5.bmp,Daniel bullies his employees to put in extra hours at work.,1,reputation,576012,576380,368,p,0
212857,38,2,3,4,7,m,Michael.jpg,pieFS2.bmp,Michael is homeless,2,na,588615,590200,1585,q,1
212857,39,2,6,9,15,m,Stuart.jpg,pieFS2.bmp,Stuart is saving to pay his university fees,2,na,602433,603581,1148,q,1
212857,40,1,10,10,20,f,Jean.jpg,pieFS1.bmp,Jean just found out that her husband has incurred a large credit card debt.,2,na,615818,616701,883,q,1
212857,41,2,6,9,15,m,Don.jpg,pieFS2.bmp,Don lives in a luxury penthouse apartment,1,resources,628937,630422,1485,q,1
212857,42,3,2,4,6,f,Fiona.jpg,pieFS3.bmp,Fiona's husband is a wealthy investment banker,1,resources,642672,643802,1130,q,1
212857,43,4,3,12,15,f,Beth.jpg,pieFS4.bmp,Beth can't afford to pay her medical bills,2,na,656040,657142,1102,q,1
212857,44,3,4,9,13,m,Matt.jpg,pieFS3.bmp,Matt stole money from his mother's wallet.,1,reputation,669376,670363,987,p,0
212857,45,3,3,7,10,f,Fay.jpg,pieFS3.bmp,Fay is going to be evicted because she is behind on her rent,2,na,682594,683803,1209,q,1
212857,46,5,2,18,20,m,Taymar.jpg,pieFS5.bmp,Taymar just lost his job,2,na,696030,697263,1233,q,1
212857,47,2,3,4,7,f,Eileen.jpg,pieFS2.bmp,Eileen is a highly paid actress,1,resources,709498,710484,986,q,1
212857,48,5,1,9,10,m,Ben.jpg,pieFS5.bmp,Ben lost his life savings when his small business failed,2,na,722700,723664,964,q,1
212857,49,4,2,8,10,f,Emily.jpg,pieFS4.bmp,Emily has to take an unpaid leave of absence because her mother broke her hip.,2,na,735886,736864,978,q,1
212857,50,4,4,16,20,f,Sammy.jpg,pieFS4.bmp,Sammy got a large cash bonus from her boss,1,resources,749088,749965,877,q,1
212857,51,3,2,4,6,f,Monica.jpg,pieFS3.bmp,Monica was a victim of identity theft and is now thousands of dollars in debt.,2,na,762190,763125,935,q,1
212857,52,3,3,7,10,m,Kevin.jpg,pieFS3.bmp,Kevin cheated on his taxes and is now under investigation for tax fraud.,1,reputation,775342,776105,763,p,0
213163,1,4,4,16,20,f,Sharon.jpg,pieFS4.bmp,Sharon secretly gambles with her husband's savings.,1,reputation,44228,52674,8446,p,0
213163,2,3,4,9,13,m,Edward.jpg,pieFS3.bmp,Edward just bought an expensive sports car,1,resources,64855,67194,2339,q,1
213163,3,3,2,4,6,f,Mary.jpg,pieFS3.bmp,Mary claims false expenses for her reportable work travel.,1,reputation,79373,83134,3761,q,1
213163,4,2,3,4,7,f,Joanna.jpg,pieFS2.bmp,Joanna got a large cash bonus from her boss,1,resources,95322,97975,2653,q,1
213163,5,3,6,14,20,m,Ian.jpg,pieFS3.bmp,Ian declared bankruptcy after he was laid off.,2,na,110155,116875,6720,q,1
213163,6,5,2,18,20,m,Alan.jpg,pieFS5.bmp,Alan is saving for his son's operation,2,na,129051,132016,2965,q,1
213163,7,3,2,4,6,f,Eileen.jpg,pieFS3.bmp,Eileen was a victim of identity theft and is now thousands of dollars in debt.,2,na,144185,146516,2331,q,1
213163,8,4,2,8,10,m,Saul.jpg,pieFS4.bmp,Saul takes valuables from his friends' homes when asked to house-sit.,1,reputation,158669,161336,2667,p,0
213163,9,4,1,4,5,m,Brad.jpg,pieFS4.bmp,Brad was injured in a hit-and-run accident and cannot afford his medical bills.,2,na,173502,177577,4075,q,1
213163,10,2,3,4,7,m,Tony.jpg,pieFS2.bmp,Tony was mugged and had his wallet stolen.,2,na,189734,204478,14744,q,1
213163,11,3,2,4,6,f,Maria.jpg,pieFS3.bmp,Maria works two waitressing jobs to pay her bills.,2,na,216638,221338,4700,q,1
213163,12,5,1,9,10,f,Louise.jpg,pieFS5.bmp,Louise works as a cleaner in a hotel,2,na,233486,236898,3412,q,1
213163,13,2,6,9,15,m,Taymar.jpg,pieFS2.bmp,Taymar bullies his employees to put in extra hours at work.,1,reputation,249052,252099,3047,p,0
213163,14,3,5,11,16,f,Kelly.jpg,pieFS3.bmp,Kelly just received a huge cash settlement,1,resources,264252,266759,2507,q,1
213163,15,4,2,8,10,f,Lauren.jpg,pieFS4.bmp,Lauren takes discarded food from grocery stores to feed her children.,2,na,278936,283620,4684,q,1
213163,16,3,3,7,10,f,Cindy.jpg,pieFS3.bmp,Cindy steals her coworkers' tips to buy alcohol.,1,reputation,295768,298300,2532,p,0
213163,17,1,8,8,16,m,Daniel.jpg,pieFS1.bmp,Daniel just lost his job,2,na,310451,319821,9370,p,0
213163,18,3,2,4,6,f,Monica.jpg,pieFS3.bmp,Monica just lost her small business after a franchise moved in next door.,2,na,331978,334981,3003,q,1
213163,19,4,1,4,5,m,Ben.jpg,pieFS4.bmp,Ben often goes through and steals the neighbors' mail.,1,reputation,347128,350561,3433,p,0
213163,20,4,3,12,15,f,Trish.jpg,pieFS4.bmp,Trish's husband is a wealthy investment banker,1,resources,362710,365882,3172,q,1
213163,21,5,2,18,20,m,George.jpg,pieFS5.bmp,George employs illegal immigrants and pays them less than minimum wage.,1,reputation,378027,381702,3675,p,0
213163,22,5,1,9,10,f,Jean.jpg,pieFS5.bmp,Jean used her mother's social security number to open a credit card account.,1,reputation,393859,396423,2564,p,0
213163,23,5,1,9,10,f,Fay.jpg,pieFS5.bmp,Fay can't afford to pay her medical bills,2,na,408577,411403,2826,q,1
213163,24,5,1,9,10,f,Miriam.jpg,pieFS5.bmp,Miriam is going to be evicted because she is behind on her rent,2,na,423577,428363,4786,q,1
213163,25,1,10,10,20,f,Marny.jpg,pieFS1.bmp,Marny is raising money to buy gifts for children in need.,2,na,440525,443384,2859,q,1
213163,26,5,1,9,10,m,Stuart.jpg,pieFS5.bmp,Stuart has been unable to find a job for over a year.,2,na,455541,457744,2203,q,1
213163,27,2,8,12,20,f,Jenny.jpg,pieFS2.bmp,Jenny illegally parks in the disabled parking spots when she can.,1,reputation,469892,472004,2112,p,0
213163,28,3,6,14,20,m,Jared.jpg,pieFS3.bmp,Jared could not afford his mortgage and his home was foreclosed.,2,na,484160,489065,4905,q,1
213163,29,3,4,9,13,m,Paul.jpg,pieFS3.bmp,Paul is hiding his taxable income in Switzerland.,1,reputation,501224,503225,2001,p,0
213163,30,2,6,9,15,m,Mark.jpg,pieFS2.bmp,Mark lost his house in a fire,2,na,515376,519986,4610,q,1
213163,31,5,2,18,20,f,Beth.jpg,pieFS5.bmp,Beth owns an international company,1,resources,532140,542326,10186,q,1
213163,32,3,3,7,10,f,Sammy.jpg,pieFS3.bmp,Sammy's car with her bag and credit cards was recently stolen.,2,na,554499,557567,3068,q,1
213163,33,1,5,5,10,f,Emma.jpg,pieFS1.bmp,Emma received a large inheritance from a distant relative,1,resources,569732,571667,1935,q,1
213163,34,2,7,10,17,f,Fiona.jpg,pieFS2.bmp,Fiona is a single mother,2,na,583817,586487,2670,q,1
213163,35,3,3,7,10,m,Peter.jpg,pieFS3.bmp,Peter just found $50 on the street,1,resources,598650,602108,3458,q,1
213163,36,5,2,18,20,m,Matt.jpg,pieFS5.bmp,Matt is homeless,2,na,614267,616208,1941,q,1
213163,37,4,4,16,20,m,Nick.jpg,pieFS4.bmp,Nick is saving to pay his university fees,2,na,628368,630568,2200,q,1
213163,38,4,1,4,5,f,Emily.jpg,pieFS4.bmp,Emily just found out that her husband has incurred a large credit card debt.,2,na,642719,646529,3810,q,1
213163,39,4,2,8,10,m,Joe.jpg,pieFS4.bmp,Joe underreports his company's earnings and pockets the profits.,1,reputation,658701,660949,2248,p,0
213163,40,1,9,9,18,m,Kevin.jpg,pieFS1.bmp,Kevin lives in a luxury penthouse apartment,1,resources,673102,676110,3008,q,1
213163,41,5,1,9,10,m,Michael.jpg,pieFS5.bmp,Michael stole money from his mother's wallet.,1,reputation,688268,691050,2782,p,0
213163,42,4,4,16,20,f,Jackie.jpg,pieFS4.bmp,Jackie is a highly paid actress,1,resources,703202,706730,3528,q,1
213163,43,5,1,9,10,f,Arianna.jpg,pieFS5.bmp,Arianna just won the lottery,1,resources,718885,725531,6646,p,0
213163,44,4,3,12,15,m,Jack.jpg,pieFS4.bmp,Jack lost his life savings when his small business failed,2,na,737681,740191,2510,q,1
213163,45,4,3,12,15,m,Darnell.jpg,pieFS4.bmp,Darnell cheated on his taxes and is now under investigation for tax fraud.,1,reputation,752364,754632,2268,p,0
213163,46,4,3,12,15,f,Deborah.jpg,pieFS4.bmp,Deborah has to take an unpaid leave of absence because her mother broke her hip.,2,na,766782,769332,2550,q,1
213163,47,5,1,9,10,m,Don.jpg,pieFS5.bmp,Don is a veteran having trouble finding employment.,2,na,781482,783892,2410,q,1
213163,48,3,4,9,13,m,Justin.jpg,pieFS3.bmp,Justin is a well paid lawyer,1,resources,796050,803873,7823,q,1
213163,49,4,2,8,10,f,Janet.jpg,pieFS4.bmp,Janet cannot afford to send her son to college.,2,na,816028,818413,2385,q,1
213163,50,5,1,9,10,f,Kay.jpg,pieFS5.bmp,Kay regularly fires employees to avoid promoting them.,1,reputation,830562,832574,2012,p,0
213163,51,5,2,18,20,m,Sam.jpg,pieFS5.bmp,Sam stole his elderly father's prescription medications.,1,reputation,844746,846614,1868,p,0
213163,52,3,5,11,16,m,Ricky.jpg,pieFS3.bmp,Ricky is a retiree,2,na,858764,860954,2190,q,1
213704,1,4,4,16,20,f,Kelly.jpg,pieFS4.bmp,Kelly illegally parks in the disabled parking spots when she can.,1,reputation,32598,37982,5384,z,1
213704,2,5,1,9,10,m,Mark.jpg,pieFS5.bmp,Mark cheated on his taxes and is now under investigation for tax fraud.,1,reputation,50088,56583,6495,m,0
213704,3,5,1,9,10,f,Fay.jpg,pieFS5.bmp,Fay claims false expenses for her reportable work travel.,1,reputation,68682,71052,2370,m,0
213704,4,5,1,9,10,m,Darnell.jpg,pieFS5.bmp,Darnell is a veteran having trouble finding employment.,2,na,83146,85475,2329,z,1
213704,5,5,2,18,20,m,Stuart.jpg,pieFS5.bmp,Stuart stole his elderly father's prescription medications.,1,reputation,97559,99331,1772,m,0
213704,6,5,2,18,20,m,Alan.jpg,pieFS5.bmp,Alan is saving for his son's operation,2,na,111421,114236,2815,m,0
213704,7,3,5,11,16,m,Tony.jpg,pieFS3.bmp,Tony declared bankruptcy after he was laid off.,2,na,126352,128425,2073,z,1
213704,8,3,2,4,6,f,Monica.jpg,pieFS3.bmp,Monica's car with her bag and credit cards was recently stolen.,2,na,140515,142342,1827,z,1
213704,9,5,2,18,20,m,George.jpg,pieFS5.bmp,George bullies his employees to put in extra hours at work.,1,reputation,154427,155053,626,m,0
213704,10,3,6,14,20,m,Edward.jpg,pieFS3.bmp,Edward just lost his job,2,na,167151,167785,634,z,1
213704,11,2,7,10,17,f,Cindy.jpg,pieFS2.bmp,Cindy just found out that her husband has incurred a large credit card debt.,2,na,179893,184284,4391,z,1
213704,12,2,6,9,15,m,Jack.jpg,pieFS2.bmp,Jack takes valuables from his friends' homes when asked to house-sit.,1,reputation,196380,201514,5134,m,0
213704,13,2,6,9,15,m,Saul.jpg,pieFS2.bmp,Saul was injured in a hit-and-run accident and cannot afford his medical bills.,2,na,213602,213945,343,z,1
213704,14,5,1,9,10,f,Eileen.jpg,pieFS5.bmp,Eileen is a highly paid actress,1,resources,226042,226619,577,z,1
213704,15,3,3,7,10,f,Sharon.jpg,pieFS3.bmp,Sharon works as a cleaner in a hotel,2,na,238717,239182,465,z,1
213704,16,4,2,8,10,f,Sammy.jpg,pieFS4.bmp,Sammy has to take an unpaid leave of absence because her mother broke her hip.,2,na,251291,251589,298,z,1
213704,17,5,2,18,20,f,Marny.jpg,pieFS5.bmp,Marny got a large cash bonus from her boss,1,resources,263664,263968,304,z,1
213704,18,2,8,12,20,f,Fiona.jpg,pieFS2.bmp,Fiona's husband is a wealthy investment banker,1,resources,276055,276380,325,z,1
213704,19,3,4,9,13,m,Justin.jpg,pieFS3.bmp,Justin employs illegal immigrants and pays them less than minimum wage.,1,reputation,288478,288830,352,m,0
213704,20,5,1,9,10,f,Trish.jpg,pieFS5.bmp,Trish can't afford to pay her medical bills,2,na,300919,301373,454,z,1
213704,21,2,3,4,7,m,Brad.jpg,pieFS2.bmp,Brad was mugged and had his wallet stolen.,2,na,313443,313799,356,z,1
213704,22,3,2,4,6,f,Jenny.jpg,pieFS3.bmp,Jenny was a victim of identity theft and is now thousands of dollars in debt.,2,na,325900,326253,353,z,1
213704,23,3,4,9,13,m,Ben.jpg,pieFS3.bmp,Ben often goes through and steals the neighbors' mail.,1,reputation,338340,338722,382,m,0
213704,24,1,8,8,16,m,Daniel.jpg,pieFS1.bmp,Daniel could not afford his mortgage and his home was foreclosed.,2,na,350830,351603,773,z,1
213704,25,3,3,7,10,m,Ricky.jpg,pieFS3.bmp,Ricky is hiding his taxable income in Switzerland.,1,reputation,363689,364052,363,m,0
213704,26,4,2,8,10,m,Taymar.jpg,pieFS4.bmp,Taymar underreports his company's earnings and pockets the profits.,1,reputation,376146,376521,375,m,0
213704,27,4,4,16,20,m,Don.jpg,pieFS4.bmp,Don has been unable to find a job for over a year.,2,na,388620,389083,463,z,1
213704,28,1,9,9,18,m,Joe.jpg,pieFS1.bmp,Joe is a well paid lawyer,1,resources,401177,401907,730,z,1
213704,29,1,10,10,20,f,Lauren.jpg,pieFS1.bmp,Lauren works two waitressing jobs to pay her bills.,2,na,414002,414657,655,z,1
213704,30,5,1,9,10,f,Mary.jpg,pieFS5.bmp,Mary is going to be evicted because she is behind on her rent,2,na,426743,427233,490,z,1
213704,31,4,1,4,5,m,Paul.jpg,pieFS4.bmp,Paul is a retiree,2,na,439317,440174,857,z,1
213704,32,4,1,4,5,m,Jared.jpg,pieFS4.bmp,Jared just bought an expensive sports car,1,resources,452259,452830,571,z,1
213704,33,3,6,14,20,m,Michael.jpg,pieFS3.bmp,Michael lost his house in a fire,2,na,464900,465598,698,z,1
213704,34,4,4,16,20,f,Janet.jpg,pieFS4.bmp,Janet owns an international company,1,resources,477692,478104,412,z,1
213704,35,3,2,4,6,f,Joanna.jpg,pieFS3.bmp,Joanna just received a huge cash settlement,1,resources,490182,490756,574,z,1
213704,36,4,3,12,15,m,Nick.jpg,pieFS4.bmp,Nick just found $50 on the street,1,resources,502840,503679,839,z,1
213704,37,5,2,18,20,m,Kevin.jpg,pieFS5.bmp,Kevin is homeless,2,na,515765,516841,1076,z,1
213704,38,5,1,9,10,f,Beth.jpg,pieFS5.bmp,Beth received a large inheritance from a distant relative,1,resources,528941,530396,1455,z,1
213704,39,4,3,12,15,f,Maria.jpg,pieFS4.bmp,Maria takes discarded food from grocery stores to feed her children.,2,na,542485,543279,794,z,1
213704,40,4,3,12,15,f,Deborah.jpg,pieFS4.bmp,Deborah steals her coworkers' tips to buy alcohol.,1,reputation,555377,555778,401,m,0
213704,41,5,1,9,10,m,Sam.jpg,pieFS5.bmp,Sam is saving to pay his university fees,2,na,567868,569713,1845,z,1
213704,42,4,2,8,10,f,Louise.jpg,pieFS4.bmp,Louise is a single mother,2,na,581813,582745,932,z,1
213704,43,3,2,4,6,f,Jackie.jpg,pieFS3.bmp,Jackie just lost her small business after a franchise moved in next door.,2,na,594839,595418,579,z,1
213704,44,1,5,5,10,f,Arianna.jpg,pieFS1.bmp,Arianna just won the lottery,1,resources,607513,608426,913,z,1
213704,45,4,2,8,10,m,Peter.jpg,pieFS4.bmp,Peter lives in a luxury penthouse apartment,1,resources,620522,621743,1221,z,1
213704,46,3,4,9,13,m,Ian.jpg,pieFS3.bmp,Ian stole money from his mother's wallet.,1,reputation,633832,634694,862,m,0
213704,47,4,1,4,5,f,Kay.jpg,pieFS4.bmp,Kay cannot afford to send her son to college.,2,na,646790,647242,452,z,1
213704,48,2,3,4,7,f,Emma.jpg,pieFS2.bmp,Emma regularly fires employees to avoid promoting them.,1,reputation,659331,660048,717,m,0
213704,49,4,3,12,15,m,Matt.jpg,pieFS4.bmp,Matt lost his life savings when his small business failed,2,na,672123,672774,651,z,1
213704,50,3,3,7,10,f,Emily.jpg,pieFS3.bmp,Emily used her mother's social security number to open a credit card account.,1,reputation,684864,686278,1414,m,0
213704,51,3,5,11,16,f,Miriam.jpg,pieFS3.bmp,Miriam secretly gambles with her husband's savings.,1,reputation,698374,699122,748,m,0
213704,52,5,1,9,10,f,Jean.jpg,pieFS5.bmp,Jean is raising money to buy gifts for children in need.,2,na,711216,711554,338,z,1
215763,1,5,1,9,10,m,Darnell.jpg,pieFS5.bmp,Darnell is homeless,2,na,190519,198044,7525,q,1
215763,2,4,1,4,5,m,Matt.jpg,pieFS4.bmp,Matt is saving to pay his university fees,2,na,210231,218164,7933,q,1
215763,3,3,4,9,13,m,Sam.jpg,pieFS3.bmp,Sam lives in a luxury penthouse apartment,1,resources,230359,233144,2785,p,0
215763,4,4,3,12,15,m,Peter.jpg,pieFS4.bmp,Peter stole money from his mother's wallet.,1,reputation,245342,251185,5843,q,1
215763,5,2,7,10,17,f,Jenny.jpg,pieFS2.bmp,Jenny's car with her bag and credit cards was recently stolen.,2,na,263372,266845,3473,q,1
215763,6,3,5,11,16,m,Stuart.jpg,pieFS3.bmp,Stuart lost his life savings when his small business failed,2,na,279022,281086,2064,p,0
215763,7,3,3,7,10,m,Brad.jpg,pieFS3.bmp,Brad cheated on his taxes and is now under investigation for tax fraud.,1,reputation,293273,293426,153,q,1
215763,8,3,2,4,6,f,Lauren.jpg,pieFS3.bmp,Lauren just found out that her husband has incurred a large credit card debt.,2,na,305576,309447,3871,q,1
215763,9,4,2,8,10,m,Joe.jpg,pieFS4.bmp,Joe just bought an expensive sports car,1,resources,321592,329167,7575,p,0
215763,10,3,6,14,20,m,Don.jpg,pieFS3.bmp,Don is a veteran having trouble finding employment.,2,na,341320,341867,547,q,1
215763,11,3,2,4,6,f,Janet.jpg,pieFS3.bmp,Janet is a single mother,2,na,354039,362948,8909,p,0
215763,12,2,6,9,15,m,Taymar.jpg,pieFS2.bmp,Taymar is saving for his son's operation,2,na,375099,375448,349,q,1
215763,13,4,3,12,15,f,Monica.jpg,pieFS4.bmp,Monica is a highly paid actress,1,resources,387602,388369,767,p,0
215763,14,5,1,9,10,f,Fay.jpg,pieFS5.bmp,Fay just won the lottery,1,resources,400521,406149,5628,q,1
215763,15,2,6,9,15,m,Justin.jpg,pieFS2.bmp,Justin bullies his employees to put in extra hours at work.,1,reputation,418318,423209,4891,q,1
215763,16,5,1,9,10,f,Emma.jpg,pieFS5.bmp,Emma cannot afford to send her son to college.,2,na,435366,435370,4,p,0
215763,17,3,2,4,6,f,Kay.jpg,pieFS3.bmp,Kay regularly fires employees to avoid promoting them.,1,reputation,447536,451050,3514,q,1
215763,18,4,1,4,5,m,Ian.jpg,pieFS4.bmp,Ian stole his elderly father's prescription medications.,1,reputation,463219,467711,4492,q,1
215763,19,5,1,9,10,m,Nick.jpg,pieFS5.bmp,Nick declared bankruptcy after he was laid off.,2,na,479884,481891,2007,p,0
215763,20,3,6,14,20,m,Daniel.jpg,pieFS3.bmp,Daniel just lost his job,2,na,494052,496011,1959,q,1
215763,21,5,1,9,10,f,Jean.jpg,pieFS5.bmp,Jean has to take an unpaid leave of absence because her mother broke her hip.,2,na,508186,510492,2306,q,1
215763,22,5,2,18,20,f,Kelly.jpg,pieFS5.bmp,Kelly got a large cash bonus from her boss,1,resources,522653,527532,4879,p,0
215763,23,1,5,5,10,f,Fiona.jpg,pieFS1.bmp,Fiona secretly gambles with her husband's savings.,1,reputation,539685,542573,2888,q,1
215763,24,5,1,9,10,f,Eileen.jpg,pieFS5.bmp,Eileen was a victim of identity theft and is now thousands of dollars in debt.,2,na,554735,557673,2938,q,1
215763,25,3,5,11,16,f,Beth.jpg,pieFS3.bmp,Beth claims false expenses for her reportable work travel.,1,reputation,569835,575133,5298,p,0
215763,26,5,2,18,20,m,Michael.jpg,pieFS5.bmp,Michael takes valuables from his friends' homes when asked to house-sit.,1,reputation,587282,591694,4412,p,0
215763,27,4,2,8,10,f,Sammy.jpg,pieFS4.bmp,Sammy works two waitressing jobs to pay her bills.,2,na,603847,608274,4427,q,1
215763,28,1,8,8,16,m,Ben.jpg,pieFS1.bmp,Ben was injured in a hit-and-run accident and cannot afford his medical bills.,2,na,620446,623334,2888,q,1
215763,29,3,3,7,10,f,Mary.jpg,pieFS3.bmp,Mary works as a cleaner in a hotel,2,na,635496,638655,3159,q,1
215763,30,5,2,18,20,m,Paul.jpg,pieFS5.bmp,Paul employs illegal immigrants and pays them less than minimum wage.,1,reputation,650845,654435,3590,p,0
215763,31,5,2,18,20,m,Mark.jpg,pieFS5.bmp,Mark was mugged and had his wallet stolen.,2,na,666611,670276,3665,p,0
215763,32,3,4,9,13,m,Tony.jpg,pieFS3.bmp,Tony often goes through and steals the neighbors' mail.,1,reputation,682427,686036,3609,q,1
215763,33,5,2,18,20,m,Kevin.jpg,pieFS5.bmp,Kevin has been unable to find a job for over a year.,2,na,698210,701596,3386,p,0
215763,34,4,4,16,20,m,Edward.jpg,pieFS4.bmp,Edward could not afford his mortgage and his home was foreclosed.,2,na,713743,717137,3394,p,0
215763,35,4,4,16,20,f,Miriam.jpg,pieFS4.bmp,Miriam's husband is a wealthy investment banker,1,resources,729292,734257,4965,p,0
215763,36,3,4,9,13,m,Ricky.jpg,pieFS3.bmp,Ricky is hiding his taxable income in Switzerland.,1,reputation,746407,749838,3431,q,1
215763,37,4,4,16,20,f,Cindy.jpg,pieFS4.bmp,Cindy just received a huge cash settlement,1,resources,762006,767858,5852,p,0
215763,38,4,3,12,15,m,Saul.jpg,pieFS4.bmp,Saul lost his house in a fire,2,na,780020,783559,3539,p,0
215763,39,3,2,4,6,f,Joanna.jpg,pieFS3.bmp,Joanna takes discarded food from grocery stores to feed her children.,2,na,795719,799399,3680,q,1
215763,40,4,2,8,10,f,Louise.jpg,pieFS4.bmp,Louise can't afford to pay her medical bills,2,na,811568,817019,5451,p,0
215763,41,5,1,9,10,f,Deborah.jpg,pieFS5.bmp,Deborah steals her coworkers' tips to buy alcohol.,1,reputation,829166,831200,2034,p,0
215763,42,4,2,8,10,m,Alan.jpg,pieFS4.bmp,Alan underreports his company's earnings and pockets the profits.,1,reputation,843350,846420,3070,q,1
215763,43,4,3,12,15,f,Trish.jpg,pieFS4.bmp,Trish is going to be evicted because she is behind on her rent,2,na,858566,863920,5354,p,0
215763,44,3,3,7,10,f,Sharon.jpg,pieFS3.bmp,Sharon owns an international company,1,resources,876097,879501,3404,q,1
215763,45,4,1,4,5,f,Maria.jpg,pieFS4.bmp,Maria just lost her small business after a franchise moved in next door.,2,na,891663,896161,4498,p,0
215763,46,2,8,12,20,f,Arianna.jpg,pieFS2.bmp,Arianna received a large inheritance from a distant relative,1,resources,908328,912062,3734,q,1
215763,47,5,1,9,10,m,Jack.jpg,pieFS5.bmp,Jack just found $50 on the street,1,resources,924227,927642,3415,p,0
215763,48,1,9,9,18,m,Jared.jpg,pieFS1.bmp,Jared is a well paid lawyer,1,resources,939794,943263,3469,q,1
215763,49,5,1,9,10,f,Emily.jpg,pieFS5.bmp,Emily used her mother's social security number to open a credit card account.,1,reputation,955410,958663,3253,p,0
215763,50,1,10,10,20,f,Marny.jpg,pieFS1.bmp,Marny is raising money to buy gifts for children in need.,2,na,970809,974383,3574,q,1
215763,51,2,3,4,7,m,George.jpg,pieFS2.bmp,George is a retiree,2,na,986559,989904,3345,q,1
215763,52,2,3,4,7,f,Jackie.jpg,pieFS2.bmp,Jackie illegally parks in the disabled parking spots when she can.,1,reputation,1002092,1004644,2552,q,1
216011,1,3,4,9,13,m,Taymar.jpg,pieFS3.bmp,Taymar is a well paid lawyer,1,resources,41226,43327,2101,q,1
216011,2,2,3,4,7,m,Ben.jpg,pieFS2.bmp,Ben declared bankruptcy after he was laid off.,2,na,55610,62508,6898,p,0
216011,3,1,10,10,20,f,Joanna.jpg,pieFS1.bmp,Joanna just lost her small business after a franchise moved in next door.,2,na,74739,78508,3769,q,1
216011,4,4,3,12,15,m,Kevin.jpg,pieFS4.bmp,Kevin takes valuables from his friends' homes when asked to house-sit.,1,reputation,90754,93708,2954,q,1
216011,5,5,2,18,20,f,Maria.jpg,pieFS5.bmp,Maria used her mother's social security number to open a credit card account.,1,reputation,105938,111129,5191,p,0
216011,6,5,2,18,20,m,Mark.jpg,pieFS5.bmp,Mark was injured in a hit-and-run accident and cannot afford his medical bills.,2,na,123352,139429,16077,q,1
216011,7,2,6,9,15,m,Michael.jpg,pieFS2.bmp,Michael was mugged and had his wallet stolen.,2,na,151654,153589,1935,q,1
216011,8,3,2,4,6,f,Trish.jpg,pieFS3.bmp,Trish can't afford to pay her medical bills,2,na,165821,167290,1469,q,1
216011,9,5,1,9,10,f,Jackie.jpg,pieFS5.bmp,Jackie is raising money to buy gifts for children in need.,2,na,179523,181050,1527,q,1
216011,10,5,1,9,10,f,Mary.jpg,pieFS5.bmp,Mary is going to be evicted because she is behind on her rent,2,na,193274,194390,1116,q,1
216011,11,3,3,7,10,f,Sharon.jpg,pieFS3.bmp,Sharon owns an international company,1,resources,206609,208690,2081,q,1
216011,12,3,6,14,20,m,Alan.jpg,pieFS3.bmp,Alan is a retiree,2,na,220910,222391,1481,q,1
216011,13,5,2,18,20,m,Justin.jpg,pieFS5.bmp,Justin just bought an expensive sports car,1,resources,234628,236171,1543,q,1
216011,14,4,3,12,15,f,Jean.jpg,pieFS4.bmp,Jean illegally parks in the disabled parking spots when she can.,1,reputation,248396,253091,4695,q,1
216011,15,4,1,4,5,m,Jared.jpg,pieFS4.bmp,Jared is saving for his son's operation,2,na,265294,266691,1397,q,1
216011,16,4,2,8,10,f,Jenny.jpg,pieFS4.bmp,Jenny's car with her bag and credit cards was recently stolen.,2,na,278912,280592,1680,q,1
216011,17,3,2,4,6,f,Monica.jpg,pieFS3.bmp,Monica just found out that her husband has incurred a large credit card debt.,2,na,292814,293652,838,q,1
216011,18,3,2,4,6,f,Deborah.jpg,pieFS3.bmp,Deborah is a highly paid actress,1,resources,305882,307472,1590,q,1
216011,19,2,7,10,17,f,Marny.jpg,pieFS2.bmp,Marny has to take an unpaid leave of absence because her mother broke her hip.,2,na,319684,321252,1568,q,1
216011,20,4,2,8,10,m,Darnell.jpg,pieFS4.bmp,Darnell often goes through and steals the neighbors' mail.,1,reputation,333469,342153,8684,p,0
216011,21,2,3,4,7,f,Arianna.jpg,pieFS2.bmp,Arianna received a large inheritance from a distant relative,1,resources,354379,356133,1754,q,1
216011,22,4,3,12,15,f,Kay.jpg,pieFS4.bmp,Kay is a single mother,2,na,368346,370053,1707,q,1
216011,23,2,8,12,20,f,Kelly.jpg,pieFS2.bmp,Kelly got a large cash bonus from her boss,1,resources,382281,384794,2513,q,1
216011,24,4,1,4,5,f,Cindy.jpg,pieFS4.bmp,Cindy was a victim of identity theft and is now thousands of dollars in debt.,2,na,397015,398714,1699,q,1
216011,25,3,2,4,6,f,Emily.jpg,pieFS3.bmp,Emily works two waitressing jobs to pay her bills.,2,na,410949,412474,1525,q,1
216011,26,5,1,9,10,f,Janet.jpg,pieFS5.bmp,Janet just won the lottery,1,resources,424684,426974,2290,q,1
216011,27,5,1,9,10,f,Sammy.jpg,pieFS5.bmp,Sammy just received a huge cash settlement,1,resources,439201,441095,1894,q,1
216011,28,3,3,7,10,f,Eileen.jpg,pieFS3.bmp,Eileen takes discarded food from grocery stores to feed her children.,2,na,453302,455155,1853,q,1
216011,29,4,4,16,20,m,Matt.jpg,pieFS4.bmp,Matt has been unable to find a job for over a year.,2,na,467370,469715,2345,q,1
216011,30,1,8,8,16,m,Nick.jpg,pieFS1.bmp,Nick lost his house in a fire,2,na,481937,483575,1638,q,1
216011,31,3,4,9,13,m,Brad.jpg,pieFS3.bmp,Brad just found $50 on the street,1,resources,495805,497856,2051,q,1
216011,32,4,3,12,15,m,Peter.jpg,pieFS4.bmp,Peter is homeless,2,na,510089,511856,1767,q,1
216011,33,4,2,8,10,f,Emma.jpg,pieFS4.bmp,Emma cannot afford to send her son to college.,2,na,524057,525516,1459,q,1
216011,34,3,5,11,16,f,Lauren.jpg,pieFS3.bmp,Lauren steals her coworkers' tips to buy alcohol.,1,reputation,537742,541036,3294,p,0
216011,35,3,5,11,16,m,Don.jpg,pieFS3.bmp,Don is saving to pay his university fees,2,na,553258,554777,1519,q,1
216011,36,4,4,16,20,f,Beth.jpg,pieFS4.bmp,Beth regularly fires employees to avoid promoting them.,1,reputation,566993,576017,9024,p,0
216011,37,3,4,9,13,m,Edward.jpg,pieFS3.bmp,Edward bullies his employees to put in extra hours at work.,1,reputation,588219,590497,2278,p,0
216011,38,5,2,18,20,m,Daniel.jpg,pieFS5.bmp,Daniel just lost his job,2,na,602736,603858,1122,q,1
216011,39,2,6,9,15,m,Saul.jpg,pieFS2.bmp,Saul lives in a luxury penthouse apartment,1,resources,616088,618078,1990,q,1
216011,40,3,3,7,10,m,Paul.jpg,pieFS3.bmp,Paul employs illegal immigrants and pays them less than minimum wage.,1,reputation,630289,637418,7129,p,0
216011,41,5,1,9,10,m,Ian.jpg,pieFS5.bmp,Ian stole money from his mother's wallet.,1,reputation,649651,652159,2508,p,0
216011,42,5,1,9,10,f,Fay.jpg,pieFS5.bmp,Fay secretly gambles with her husband's savings.,1,reputation,664368,666439,2071,p,0
216011,43,5,1,9,10,m,Stuart.jpg,pieFS5.bmp,Stuart lost his life savings when his small business failed,2,na,678652,680119,1467,q,1
216011,44,1,9,9,18,m,Sam.jpg,pieFS1.bmp,Sam cheated on his taxes and is now under investigation for tax fraud.,1,reputation,692337,695419,3082,p,0
216011,45,5,1,9,10,m,Tony.jpg,pieFS5.bmp,Tony is a veteran having trouble finding employment.,2,na,707653,709320,1667,q,1
216011,46,3,6,14,20,m,George.jpg,pieFS3.bmp,George could not afford his mortgage and his home was foreclosed.,2,na,721521,723180,1659,q,1
216011,47,1,5,5,10,f,Miriam.jpg,pieFS1.bmp,Miriam claims false expenses for her reportable work travel.,1,reputation,735406,746321,10915,p,0
216011,48,4,2,8,10,m,Joe.jpg,pieFS4.bmp,Joe is hiding his taxable income in Switzerland.,1,reputation,758530,760501,1971,p,0
216011,49,5,1,9,10,f,Fiona.jpg,pieFS5.bmp,Fiona works as a cleaner in a hotel,2,na,772714,774521,1807,q,1
216011,50,4,4,16,20,f,Louise.jpg,pieFS4.bmp,Louise's husband is a wealthy investment banker,1,resources,786732,789241,2509,q,1
216011,51,5,2,18,20,m,Jack.jpg,pieFS5.bmp,Jack stole his elderly father's prescription medications.,1,reputation,801466,803461,1995,p,0
216011,52,4,1,4,5,m,Ricky.jpg,pieFS4.bmp,Ricky underreports his company's earnings and pockets the profits.,1,reputation,815683,818962,3279,p,0
216806,1,1,9,9,18,m,Jack.jpg,pieFS1.bmp,Jack stole money from his mother's wallet.,1,reputation,44773,47817,3044,p,0
216806,2,5,1,9,10,f,Sharon.jpg,pieFS5.bmp,Sharon received a large inheritance from a distant relative,1,resources,60056,63037,2981,q,1
216806,3,2,3,4,7,f,Kelly.jpg,pieFS2.bmp,Kelly just received a huge cash settlement,1,resources,75289,76557,1268,q,1
216806,4,4,2,8,10,f,Jean.jpg,pieFS4.bmp,Jean takes discarded food from grocery stores to feed her children.,2,na,88807,90197,1390,p,0
216806,5,3,6,14,20,m,Brad.jpg,pieFS3.bmp,Brad lost his life savings when his small business failed,2,na,102408,103977,1569,q,1
216806,6,3,5,11,16,f,Monica.jpg,pieFS3.bmp,Monica steals her coworkers' tips to buy alcohol.,1,reputation,116209,117777,1568,p,0
216806,7,4,3,12,15,m,Justin.jpg,pieFS4.bmp,Justin just lost his job,2,na,130010,131097,1087,q,1
216806,8,4,3,12,15,f,Mary.jpg,pieFS4.bmp,Mary is a single mother,2,na,143312,144277,965,q,1
216806,9,4,3,12,15,f,Emma.jpg,pieFS4.bmp,Emma just won the lottery,1,resources,156497,157637,1140,q,1
216806,10,5,1,9,10,m,Jared.jpg,pieFS5.bmp,Jared employs illegal immigrants and pays them less than minimum wage.,1,reputation,169865,171357,1492,p,0
216806,11,3,2,4,6,f,Fay.jpg,pieFS3.bmp,Fay cannot afford to send her son to college.,2,na,183583,184636,1053,q,1
216806,12,3,2,4,6,f,Deborah.jpg,pieFS3.bmp,Deborah just lost her small business after a franchise moved in next door.,2,na,196868,198056,1188,q,1
216806,13,3,4,9,13,m,Saul.jpg,pieFS3.bmp,Saul cheated on his taxes and is now under investigation for tax fraud.,1,reputation,210286,211116,830,p,0
216806,14,4,1,4,5,m,Matt.jpg,pieFS4.bmp,Matt is a veteran having trouble finding employment.,2,na,223338,224196,858,q,1
216806,15,5,1,9,10,f,Joanna.jpg,pieFS5.bmp,Joanna used her mother's social security number to open a credit card account.,1,reputation,236406,237136,730,p,0
216806,16,5,1,9,10,m,Joe.jpg,pieFS5.bmp,Joe could not afford his mortgage and his home was foreclosed.,2,na,249358,250816,1458,q,1
216806,17,4,4,16,20,f,Trish.jpg,pieFS4.bmp,Trish regularly fires employees to avoid promoting them.,1,reputation,263060,264476,1416,p,0
216806,18,5,2,18,20,f,Miriam.jpg,pieFS5.bmp,Miriam secretly gambles with her husband's savings.,1,reputation,276727,277596,869,p,0
216806,19,5,1,9,10,f,Eileen.jpg,pieFS5.bmp,Eileen is raising money to buy gifts for children in need.,2,na,289846,290936,1090,q,1
216806,20,3,4,9,13,m,Darnell.jpg,pieFS3.bmp,Darnell stole his elderly father's prescription medications.,1,reputation,303164,303916,752,p,0
216806,21,1,8,8,16,m,Don.jpg,pieFS1.bmp,Don declared bankruptcy after he was laid off.,2,na,316166,317176,1010,q,1
216806,22,2,6,9,15,m,George.jpg,pieFS2.bmp,George is hiding his taxable income in Switzerland.,1,reputation,329434,330816,1382,p,0
216806,23,4,3,12,15,m,Ben.jpg,pieFS4.bmp,Ben takes valuables from his friends' homes when asked to house-sit.,1,reputation,343086,343756,670,p,0
216806,24,5,1,9,10,f,Beth.jpg,pieFS5.bmp,Beth claims false expenses for her reportable work travel.,1,reputation,356021,356936,915,p,0
216806,25,4,4,16,20,f,Lauren.jpg,pieFS4.bmp,Lauren illegally parks in the disabled parking spots when she can.,1,reputation,369206,370436,1230,p,0
216806,26,3,3,7,10,f,Emily.jpg,pieFS3.bmp,Emily's car with her bag and credit cards was recently stolen.,2,na,382707,383736,1029,q,1
216806,27,3,6,14,20,m,Nick.jpg,pieFS3.bmp,Nick was injured in a hit-and-run accident and cannot afford his medical bills.,2,na,396009,397196,1187,q,1
216806,28,4,2,8,10,m,Taymar.jpg,pieFS4.bmp,Taymar underreports his company's earnings and pockets the profits.,1,reputation,409460,410156,696,p,0
216806,29,2,6,9,15,m,Mark.jpg,pieFS2.bmp,Mark was mugged and had his wallet stolen.,2,na,422429,423495,1066,q,1
216806,30,4,1,4,5,f,Arianna.jpg,pieFS4.bmp,Arianna works as a cleaner in a hotel,2,na,435764,436535,771,q,1
216806,31,3,3,7,10,f,Louise.jpg,pieFS3.bmp,Louise's husband is a wealthy investment banker,1,resources,448816,449636,820,q,1
216806,32,2,7,10,17,f,Fiona.jpg,pieFS2.bmp,Fiona can't afford to pay her medical bills,2,na,461901,462575,674,q,1
216806,33,3,4,9,13,m,Kevin.jpg,pieFS3.bmp,Kevin often goes through and steals the neighbors' mail.,1,reputation,474853,475755,902,p,0
216806,34,5,1,9,10,f,Jackie.jpg,pieFS5.bmp,Jackie just found out that her husband has incurred a large credit card debt.,2,na,488021,488875,854,q,1
216806,35,2,8,12,20,f,Jenny.jpg,pieFS2.bmp,Jenny is a highly paid actress,1,resources,501123,501815,692,q,1
216806,36,1,10,10,20,f,Sammy.jpg,pieFS1.bmp,Sammy has to take an unpaid leave of absence because her mother broke her hip.,2,na,514092,515495,1403,q,1
216806,37,4,1,4,5,m,Alan.jpg,pieFS4.bmp,Alan is a well paid lawyer,1,resources,527743,528955,1212,q,1
216806,38,3,5,11,16,m,Paul.jpg,pieFS3.bmp,Paul is a retiree,2,na,541211,542135,924,q,1
216806,39,3,2,4,6,f,Maria.jpg,pieFS3.bmp,Maria got a large cash bonus from her boss,1,resources,554363,555095,732,q,1
216806,40,5,2,18,20,m,Daniel.jpg,pieFS5.bmp,Daniel just bought an expensive sports car,1,resources,567365,568135,770,q,1
216806,41,5,1,9,10,f,Cindy.jpg,pieFS5.bmp,Cindy was a victim of identity theft and is now thousands of dollars in debt.,2,na,580384,581675,1291,q,1
216806,42,2,3,4,7,m,Edward.jpg,pieFS2.bmp,Edward is saving for his son's operation,2,na,593935,594875,940,q,1
216806,43,4,4,16,20,m,Stuart.jpg,pieFS4.bmp,Stuart has been unable to find a job for over a year.,2,na,607137,607735,598,q,1
216806,44,5,2,18,20,m,Peter.jpg,pieFS5.bmp,Peter lost his house in a fire,2,na,619989,620975,986,q,1
216806,45,4,2,8,10,f,Janet.jpg,pieFS4.bmp,Janet is going to be evicted because she is behind on her rent,2,na,633240,633995,755,q,1
216806,46,3,2,4,6,f,Marny.jpg,pieFS3.bmp,Marny works two waitressing jobs to pay her bills.,2,na,646242,647035,793,q,1
216806,47,1,5,5,10,f,Kay.jpg,pieFS1.bmp,Kay owns an international company,1,resources,659261,660195,934,q,1
216806,48,3,3,7,10,m,Michael.jpg,pieFS3.bmp,Michael just found $50 on the street,1,resources,672446,673194,748,q,1
216806,49,5,1,9,10,m,Ian.jpg,pieFS5.bmp,Ian is homeless,2,na,685431,686175,744,q,1
216806,50,4,2,8,10,m,Ricky.jpg,pieFS4.bmp,Ricky bullies his employees to put in extra hours at work.,1,reputation,698400,698955,555,p,0
216806,51,5,2,18,20,m,Tony.jpg,pieFS5.bmp,Tony is saving to pay his university fees,2,na,711185,711694,509,q,1
216806,52,5,2,18,20,m,Sam.jpg,pieFS5.bmp,Sam lives in a luxury penthouse apartment,1,resources,723921,724854,933,q,1
216845,1,3,3,7,10,m,Edward.jpg,pieFS3.bmp,Edward bullies his employees to put in extra hours at work.,1,reputation,79463,92601,13138,p,0
216845,2,1,8,8,16,m,Daniel.jpg,pieFS1.bmp,Daniel just lost his job,2,na,104768,111581,6813,q,1
216845,3,2,6,9,15,m,Darnell.jpg,pieFS2.bmp,Darnell was injured in a hit-and-run accident and cannot afford his medical bills.,2,na,123764,124121,357,q,1
216845,4,5,2,18,20,m,Sam.jpg,pieFS5.bmp,Sam was mugged and had his wallet stolen.,2,na,136300,137581,1281,q,1
216845,5,2,7,10,17,f,Sharon.jpg,pieFS2.bmp,Sharon cannot afford to send her son to college.,2,na,149768,150481,713,q,1
216845,6,3,3,7,10,f,Lauren.jpg,pieFS3.bmp,Lauren got a large cash bonus from her boss,1,resources,162653,163541,888,p,0
216845,7,4,4,16,20,f,Miriam.jpg,pieFS4.bmp,Miriam regularly fires employees to avoid promoting them.,1,reputation,175722,177861,2139,p,0
216845,8,5,1,9,10,m,Nick.jpg,pieFS5.bmp,Nick often goes through and steals the neighbors' mail.,1,reputation,190039,191022,983,p,0
216845,9,4,3,12,15,m,Ben.jpg,pieFS4.bmp,Ben has been unable to find a job for over a year.,2,na,203191,205522,2331,q,1
216845,10,3,5,11,16,m,Mark.jpg,pieFS3.bmp,Mark lost his house in a fire,2,na,217692,219022,1330,q,1
216845,11,4,2,8,10,m,Jared.jpg,pieFS4.bmp,Jared employs illegal immigrants and pays them less than minimum wage.,1,reputation,231193,232142,949,q,1
216845,12,4,3,12,15,f,Trish.jpg,pieFS4.bmp,Trish secretly gambles with her husband's savings.,1,reputation,244312,245842,1530,p,0
216845,13,4,3,12,15,f,Jean.jpg,pieFS4.bmp,Jean was a victim of identity theft and is now thousands of dollars in debt.,2,na,258030,259922,1892,q,1
216845,14,5,2,18,20,m,Ian.jpg,pieFS5.bmp,Ian just found $50 on the street,1,resources,272098,272683,585,p,0
216845,15,5,1,9,10,m,Taymar.jpg,pieFS5.bmp,Taymar could not afford his mortgage and his home was foreclosed.,2,na,284867,286303,1436,q,1
216845,16,5,1,9,10,m,Peter.jpg,pieFS5.bmp,Peter is homeless,2,na,298468,298763,295,q,1
216845,17,5,1,9,10,f,Emma.jpg,pieFS5.bmp,Emma claims false expenses for her reportable work travel.,1,reputation,310938,311943,1005,p,0
216845,18,3,6,14,20,m,Jack.jpg,pieFS3.bmp,Jack is saving to pay his university fees,2,na,324123,324803,680,q,1
216845,19,3,2,4,6,f,Eileen.jpg,pieFS3.bmp,Eileen works two waitressing jobs to pay her bills.,2,na,336975,337803,828,q,1
216845,20,3,5,11,16,f,Kelly.jpg,pieFS3.bmp,Kelly just received a huge cash settlement,1,resources,349977,350363,386,p,0
216845,21,4,2,8,10,f,Monica.jpg,pieFS4.bmp,Monica takes discarded food from grocery stores to feed her children.,2,na,362547,365703,3156,q,1
216845,22,3,4,9,13,m,Alan.jpg,pieFS3.bmp,Alan is hiding his taxable income in Switzerland.,1,reputation,377880,378844,964,p,0
216845,23,2,8,12,20,f,Jackie.jpg,pieFS2.bmp,Jackie steals her coworkers' tips to buy alcohol.,1,reputation,391032,391804,772,p,0
216845,24,3,2,4,6,f,Sammy.jpg,pieFS3.bmp,Sammy just lost her small business after a franchise moved in next door.,2,na,403984,406084,2100,q,1
216845,25,2,6,9,15,m,Saul.jpg,pieFS2.bmp,Saul lives in a luxury penthouse apartment,1,resources,418251,418644,393,p,0
216845,26,5,1,9,10,f,Kay.jpg,pieFS5.bmp,Kay works as a cleaner in a hotel,2,na,430820,431304,484,q,1
216845,27,5,1,9,10,f,Mary.jpg,pieFS5.bmp,Mary's husband is a wealthy investment banker,1,resources,443490,443864,374,p,0
216845,28,3,4,9,13,m,Joe.jpg,pieFS3.bmp,Joe underreports his company's earnings and pockets the profits.,1,reputation,456042,457264,1222,p,0
216845,29,4,1,4,5,m,Kevin.jpg,pieFS4.bmp,Kevin stole money from his mother's wallet.,1,reputation,469444,469964,520,p,0
216845,30,4,1,4,5,f,Arianna.jpg,pieFS4.bmp,Arianna can't afford to pay her medical bills,2,na,482146,482685,539,q,1
216845,31,1,9,9,18,m,Justin.jpg,pieFS1.bmp,Justin is a well paid lawyer,1,resources,494866,495245,379,p,0
216845,32,4,4,16,20,m,Brad.jpg,pieFS4.bmp,Brad lost his life savings when his small business failed,2,na,507418,507905,487,q,1
216845,33,1,5,5,10,f,Deborah.jpg,pieFS1.bmp,Deborah used her mother's social security number to open a credit card account.,1,reputation,520087,520445,358,q,1
216845,34,4,2,8,10,m,Stuart.jpg,pieFS4.bmp,Stuart cheated on his taxes and is now under investigation for tax fraud.,1,reputation,532623,533405,782,p,0
216845,35,4,2,8,10,f,Janet.jpg,pieFS4.bmp,Janet is going to be evicted because she is behind on her rent,2,na,545575,547225,1650,p,0
216845,36,4,1,4,5,m,Paul.jpg,pieFS4.bmp,Paul is a retiree,2,na,559410,561066,1656,q,1
216845,37,3,3,7,10,f,Maria.jpg,pieFS3.bmp,Maria is raising money to buy gifts for children in need.,2,na,573245,573786,541,q,1
216845,38,5,2,18,20,m,George.jpg,pieFS5.bmp,George just bought an expensive sports car,1,resources,585964,586466,502,p,0
216845,39,3,6,14,20,m,Tony.jpg,pieFS3.bmp,Tony is a veteran having trouble finding employment.,2,na,598633,599206,573,q,1
216845,40,5,2,18,20,f,Fiona.jpg,pieFS5.bmp,Fiona owns an international company,1,resources,611385,612186,801,p,0
216845,41,3,2,4,6,f,Beth.jpg,pieFS3.bmp,Beth received a large inheritance from a distant relative,1,resources,624371,625046,675,p,0
216845,42,3,2,4,6,f,Louise.jpg,pieFS3.bmp,Louise is a single mother,2,na,637223,637526,303,q,1
216845,43,5,1,9,10,f,Fay.jpg,pieFS5.bmp,Fay just won the lottery,1,resources,649709,650046,337,p,0
216845,44,2,3,4,7,f,Jenny.jpg,pieFS2.bmp,Jenny illegally parks in the disabled parking spots when she can.,1,reputation,662228,662747,519,p,0
216845,45,1,10,10,20,f,Emily.jpg,pieFS1.bmp,Emily's car with her bag and credit cards was recently stolen.,2,na,674931,676807,1876,q,1
216845,46,4,3,12,15,m,Don.jpg,pieFS4.bmp,Don stole his elderly father's prescription medications.,1,reputation,688982,689547,565,p,0
216845,47,2,3,4,7,m,Matt.jpg,pieFS2.bmp,Matt declared bankruptcy after he was laid off.,2,na,701718,702327,609,q,1
216845,48,5,1,9,10,f,Joanna.jpg,pieFS5.bmp,Joanna just found out that her husband has incurred a large credit card debt.,2,na,714503,715247,744,q,1
216845,49,4,4,16,20,f,Cindy.jpg,pieFS4.bmp,Cindy is a highly paid actress,1,resources,727422,727707,285,p,0
216845,50,5,2,18,20,m,Ricky.jpg,pieFS5.bmp,Ricky is saving for his son's operation,2,na,739875,740447,572,q,1
216845,51,5,1,9,10,f,Marny.jpg,pieFS5.bmp,Marny has to take an unpaid leave of absence because her mother broke her hip.,2,na,752627,754088,1461,q,1
216845,52,3,4,9,13,m,Michael.jpg,pieFS3.bmp,Michael takes valuables from his friends' homes when asked to house-sit.,1,reputation,766262,766708,446,p,0
217048,1,4,4,16,20,f,Jenny.jpg,pieFS4.bmp,Jenny used her mother's social security number to open a credit card account.,1,reputation,48276,51008,2732,p,0
217048,2,4,3,12,15,m,Darnell.jpg,pieFS4.bmp,Darnell cheated on his taxes and is now under investigation for tax fraud.,1,reputation,63210,67008,3798,p,0
217048,3,5,1,9,10,f,Sharon.jpg,pieFS5.bmp,Sharon just won the lottery,1,resources,79209,80489,1280,q,1
217048,4,4,3,12,15,f,Louise.jpg,pieFS4.bmp,Louise cannot afford to send her son to college.,2,na,92677,95429,2752,p,0
217048,5,3,6,14,20,m,Taymar.jpg,pieFS3.bmp,Taymar could not afford his mortgage and his home was foreclosed.,2,na,107661,109729,2068,q,1
217048,6,4,2,8,10,f,Cindy.jpg,pieFS4.bmp,Cindy is raising money to buy gifts for children in need.,2,na,121978,123290,1312,q,1
217048,7,4,4,16,20,f,Miriam.jpg,pieFS4.bmp,Miriam regularly fires employees to avoid promoting them.,1,reputation,135530,137410,1880,q,1
217048,8,5,1,9,10,f,Jean.jpg,pieFS5.bmp,Jean illegally parks in the disabled parking spots when she can.,1,reputation,149614,152770,3156,p,0
217048,9,4,2,8,10,m,Jared.jpg,pieFS4.bmp,Jared is hiding his taxable income in Switzerland.,1,reputation,164964,166151,1187,q,1
217048,10,4,1,4,5,m,George.jpg,pieFS4.bmp,George underreports his company's earnings and pockets the profits.,1,reputation,178349,180611,2262,p,0
217048,11,4,1,4,5,m,Matt.jpg,pieFS4.bmp,Matt is a veteran having trouble finding employment.,2,na,192800,193852,1052,q,1
217048,12,2,3,4,7,f,Emma.jpg,pieFS2.bmp,Emma secretly gambles with her husband's savings.,1,reputation,206052,207772,1720,q,1
217048,13,3,4,9,13,m,Joe.jpg,pieFS3.bmp,Joe is a well paid lawyer,1,resources,219937,221372,1435,q,1
217048,14,5,1,9,10,f,Beth.jpg,pieFS5.bmp,Beth claims false expenses for her reportable work travel.,1,reputation,233539,235913,2374,q,1
217048,15,2,7,10,17,f,Maria.jpg,pieFS2.bmp,Maria's car with her bag and credit cards was recently stolen.,2,na,248089,249793,1704,q,1
217048,16,3,2,4,6,f,Kelly.jpg,pieFS3.bmp,Kelly just found out that her husband has incurred a large credit card debt.,2,na,261974,263353,1379,q,1
217048,17,5,2,18,20,f,Jackie.jpg,pieFS5.bmp,Jackie is a highly paid actress,1,resources,275526,276734,1208,q,1
217048,18,5,1,9,10,f,Fiona.jpg,pieFS5.bmp,Fiona works as a cleaner in a hotel,2,na,288911,290074,1163,q,1
217048,19,3,3,7,10,f,Emily.jpg,pieFS3.bmp,Emily has to take an unpaid leave of absence because her mother broke her hip.,2,na,302263,303394,1131,q,1
217048,20,3,4,9,13,m,Nick.jpg,pieFS3.bmp,Nick stole his elderly father's prescription medications.,1,reputation,315565,317595,2030,q,1
217048,21,1,5,5,10,f,Mary.jpg,pieFS1.bmp,Mary's husband is a wealthy investment banker,1,resources,329766,330735,969,q,1
217048,22,3,2,4,6,f,Monica.jpg,pieFS3.bmp,Monica got a large cash bonus from her boss,1,resources,342935,343955,1020,q,1
217048,23,4,2,8,10,f,Janet.jpg,pieFS4.bmp,Janet can't afford to pay her medical bills,2,na,356153,357336,1183,q,1
217048,24,3,6,14,20,m,Brad.jpg,pieFS3.bmp,Brad declared bankruptcy after he was laid off.,2,na,369522,370856,1334,q,1
217048,25,3,2,4,6,f,Deborah.jpg,pieFS3.bmp,Deborah was a victim of identity theft and is now thousands of dollars in debt.,2,na,383057,384156,1099,q,1
217048,26,4,2,8,10,m,Michael.jpg,pieFS4.bmp,Michael takes valuables from his friends' homes when asked to house-sit.,1,reputation,396359,398337,1978,q,1
217048,27,3,5,11,16,m,Ian.jpg,pieFS3.bmp,Ian was injured in a hit-and-run accident and cannot afford his medical bills.,2,na,410527,412137,1610,q,1
217048,28,5,1,9,10,f,Trish.jpg,pieFS5.bmp,Trish is going to be evicted because she is behind on her rent,2,na,424328,425618,1290,q,1
217048,29,1,10,10,20,f,Sammy.jpg,pieFS1.bmp,Sammy works two waitressing jobs to pay her bills.,2,na,437813,439358,1545,q,1
217048,30,5,2,18,20,m,Ricky.jpg,pieFS5.bmp,Ricky is a retiree,2,na,451532,454778,3246,q,1
217048,31,1,8,8,16,m,Don.jpg,pieFS1.bmp,Don was mugged and had his wallet stolen.,2,na,466965,468659,1694,q,1
217048,32,2,6,9,15,m,Paul.jpg,pieFS2.bmp,Paul just bought an expensive sports car,1,resources,480833,483139,2306,q,1
217048,33,2,8,12,20,f,Fay.jpg,pieFS2.bmp,Fay owns an international company,1,resources,495333,496659,1326,q,1
217048,34,3,3,7,10,m,Jack.jpg,pieFS3.bmp,Jack often goes through and steals the neighbors' mail.,1,reputation,508852,511240,2388,q,1
217048,35,4,4,16,20,m,Ben.jpg,pieFS4.bmp,Ben has been unable to find a job for over a year.,2,na,523419,524460,1041,q,1
217048,36,3,3,7,10,f,Joanna.jpg,pieFS3.bmp,Joanna just received a huge cash settlement,1,resources,536621,537520,899,q,1
217048,37,5,1,9,10,m,Stuart.jpg,pieFS5.bmp,Stuart lost his house in a fire,2,na,549690,550701,1011,q,1
217048,38,1,9,9,18,m,Mark.jpg,pieFS1.bmp,Mark just found $50 on the street,1,resources,562892,564581,1689,q,1
217048,39,5,2,18,20,m,Kevin.jpg,pieFS5.bmp,Kevin is homeless,2,na,576777,578082,1305,q,1
217048,40,2,6,9,15,m,Alan.jpg,pieFS2.bmp,Alan is saving for his son's operation,2,na,590279,591362,1083,q,1
217048,41,4,3,12,15,m,Sam.jpg,pieFS4.bmp,Sam is saving to pay his university fees,2,na,603564,604562,998,q,1
217048,42,5,1,9,10,m,Peter.jpg,pieFS5.bmp,Peter lives in a luxury penthouse apartment,1,resources,616766,617983,1217,q,1
217048,43,5,2,18,20,m,Daniel.jpg,pieFS5.bmp,Daniel bullies his employees to put in extra hours at work.,1,reputation,630151,631263,1112,q,1
217048,44,3,4,9,13,m,Saul.jpg,pieFS3.bmp,Saul stole money from his mother's wallet.,1,reputation,643453,644803,1350,q,1
217048,45,4,3,12,15,f,Kay.jpg,pieFS4.bmp,Kay received a large inheritance from a distant relative,1,resources,656955,658264,1309,q,1
217048,46,3,2,4,6,f,Marny.jpg,pieFS3.bmp,Marny takes discarded food from grocery stores to feed her children.,2,na,670440,671784,1344,q,1
217048,47,5,1,9,10,f,Arianna.jpg,pieFS5.bmp,Arianna is a single mother,2,na,683959,685164,1205,q,1
217048,48,3,5,11,16,f,Eileen.jpg,pieFS3.bmp,Eileen steals her coworkers' tips to buy alcohol.,1,reputation,697327,698785,1458,q,1
217048,49,4,1,4,5,f,Lauren.jpg,pieFS4.bmp,Lauren just lost her small business after a franchise moved in next door.,2,na,710979,712105,1126,q,1
217048,50,5,1,9,10,m,Edward.jpg,pieFS5.bmp,Edward just lost his job,2,na,724281,725205,924,q,1
217048,51,2,3,4,7,m,Tony.jpg,pieFS2.bmp,Tony lost his life savings when his small business failed,2,na,737367,739166,1799,q,1
217048,52,5,2,18,20,m,Justin.jpg,pieFS5.bmp,Justin employs illegal immigrants and pays them less than minimum wage.,1,reputation,751351,753446,2095,q,1
217173,1,2,7,10,17,f,Deborah.jpg,pieFS2.bmp,Deborah just lost her small business after a franchise moved in next door.,2,na,117581,122722,5141,q,1
217173,2,3,4,9,13,m,Justin.jpg,pieFS3.bmp,Justin just bought an expensive sports car,1,resources,134895,136483,1588,q,1
217173,3,4,1,4,5,f,Arianna.jpg,pieFS4.bmp,Arianna works as a cleaner in a hotel,2,na,148647,150423,1776,q,1
217173,4,4,3,12,15,f,Jenny.jpg,pieFS4.bmp,Jenny used her mother's social security number to open a credit card account.,1,reputation,162598,164203,1605,q,1
217173,5,3,6,14,20,m,Taymar.jpg,pieFS3.bmp,Taymar is saving for his son's operation,2,na,176383,179264,2881,q,1
217173,6,1,5,5,10,f,Louise.jpg,pieFS1.bmp,Louise's husband is a wealthy investment banker,1,resources,191433,192784,1351,q,1
217173,7,3,2,4,6,f,Fay.jpg,pieFS3.bmp,Fay can't afford to pay her medical bills,2,na,204935,209305,4370,q,1
217173,8,4,2,8,10,m,Michael.jpg,pieFS4.bmp,Michael lives in a luxury penthouse apartment,1,resources,221467,225385,3918,q,1
217173,9,4,2,8,10,m,Kevin.jpg,pieFS4.bmp,Kevin stole money from his mother's wallet.,1,reputation,237532,241605,4073,p,0
217173,10,3,3,7,10,f,Fiona.jpg,pieFS3.bmp,Fiona is going to be evicted because she is behind on her rent,2,na,253764,257946,4182,p,0
217173,11,3,2,4,6,f,Maria.jpg,pieFS3.bmp,Maria is raising money to buy gifts for children in need.,2,na,270096,271646,1550,q,1
217173,12,3,2,4,6,f,Lauren.jpg,pieFS3.bmp,Lauren illegally parks in the disabled parking spots when she can.,1,reputation,283815,284887,1072,q,1
217173,13,5,1,9,10,m,George.jpg,pieFS5.bmp,George bullies his employees to put in extra hours at work.,1,reputation,297033,299507,2474,p,0
217173,14,5,2,18,20,m,Stuart.jpg,pieFS5.bmp,Stuart lost his life savings when his small business failed,2,na,311667,314047,2380,q,1
217173,15,1,9,9,18,m,Ben.jpg,pieFS1.bmp,Ben cheated on his taxes and is now under investigation for tax fraud.,1,reputation,326268,329068,2800,q,1
217173,16,2,3,4,7,m,Brad.jpg,pieFS2.bmp,Brad is a veteran having trouble finding employment.,2,na,341251,343728,2477,q,1
217173,17,4,2,8,10,f,Emily.jpg,pieFS4.bmp,Emily's car with her bag and credit cards was recently stolen.,2,na,355902,357388,1486,q,1
217173,18,4,3,12,15,m,Matt.jpg,pieFS4.bmp,Matt stole his elderly father's prescription medications.,1,reputation,369570,373989,4419,q,1
217173,19,2,6,9,15,m,Don.jpg,pieFS2.bmp,Don declared bankruptcy after he was laid off.,2,na,386152,390889,4737,q,1
217173,20,2,8,12,20,f,Janet.jpg,pieFS2.bmp,Janet owns an international company,1,resources,403050,404450,1400,q,1
217173,21,1,10,10,20,f,Sammy.jpg,pieFS1.bmp,Sammy just found out that her husband has incurred a large credit card debt.,2,na,416618,418370,1752,q,1
217173,22,5,2,18,20,m,Saul.jpg,pieFS5.bmp,Saul takes valuables from his friends' homes when asked to house-sit.,1,reputation,430536,433990,3454,p,0
217173,23,3,5,11,16,m,Jack.jpg,pieFS3.bmp,Jack was injured in a hit-and-run accident and cannot afford his medical bills.,2,na,446169,448011,1842,q,1
217173,24,5,2,18,20,f,Marny.jpg,pieFS5.bmp,Marny is a highly paid actress,1,resources,460187,462371,2184,q,1
217173,25,5,2,18,20,m,Joe.jpg,pieFS5.bmp,Joe just lost his job,2,na,474521,476992,2471,q,1
217173,26,2,3,4,7,f,Emma.jpg,pieFS2.bmp,Emma received a large inheritance from a distant relative,1,resources,489172,490492,1320,q,1
217173,27,5,1,9,10,f,Eileen.jpg,pieFS5.bmp,Eileen has to take an unpaid leave of absence because her mother broke her hip.,2,na,502673,505372,2699,q,1
217173,28,4,4,16,20,f,Jackie.jpg,pieFS4.bmp,Jackie got a large cash bonus from her boss,1,resources,517540,518893,1353,q,1
217173,29,4,3,12,15,m,Sam.jpg,pieFS4.bmp,Sam was mugged and had his wallet stolen.,2,na,531109,532393,1284,q,1
217173,30,5,2,18,20,m,Peter.jpg,pieFS5.bmp,Peter often goes through and steals the neighbors' mail.,1,reputation,544611,549494,4883,p,0
217173,31,3,3,7,10,m,Jared.jpg,pieFS3.bmp,Jared employs illegal immigrants and pays them less than minimum wage.,1,reputation,561708,566374,4666,p,0
217173,32,3,2,4,6,f,Cindy.jpg,pieFS3.bmp,Cindy was a victim of identity theft and is now thousands of dollars in debt.,2,na,578590,580695,2105,q,1
217173,33,5,1,9,10,m,Ricky.jpg,pieFS5.bmp,Ricky could not afford his mortgage and his home was foreclosed.,2,na,592907,595155,2248,q,1
217173,34,3,4,9,13,m,Paul.jpg,pieFS3.bmp,Paul is hiding his taxable income in Switzerland.,1,reputation,607375,613295,5920,p,0
217173,35,4,2,8,10,f,Beth.jpg,pieFS4.bmp,Beth is a single mother,2,na,625505,626736,1231,q,1
217173,36,4,4,16,20,f,Kay.jpg,pieFS4.bmp,Kay just won the lottery,1,resources,638940,640396,1456,q,1
217173,37,5,1,9,10,m,Darnell.jpg,pieFS5.bmp,Darnell has been unable to find a job for over a year.,2,na,652608,654176,1568,q,1
217173,38,4,1,4,5,m,Alan.jpg,pieFS4.bmp,Alan underreports his company's earnings and pockets the profits.,1,reputation,666410,669557,3147,p,0
217173,39,3,6,14,20,m,Mark.jpg,pieFS3.bmp,Mark lost his house in a fire,2,na,681776,682997,1221,q,1
217173,40,4,3,12,15,f,Mary.jpg,pieFS4.bmp,Mary cannot afford to send her son to college.,2,na,695211,696598,1387,q,1
217173,41,5,1,9,10,f,Jean.jpg,pieFS5.bmp,Jean works two waitressing jobs to pay her bills.,2,na,708813,709898,1085,q,1
217173,42,3,4,9,13,m,Edward.jpg,pieFS3.bmp,Edward is a well paid lawyer,1,resources,722115,723238,1123,q,1
217173,43,5,1,9,10,f,Trish.jpg,pieFS5.bmp,Trish regularly fires employees to avoid promoting them.,1,reputation,735450,738379,2929,p,0
217173,44,3,5,11,16,f,Miriam.jpg,pieFS3.bmp,Miriam secretly gambles with her husband's savings.,1,reputation,750584,754459,3875,q,1
217173,45,5,1,9,10,f,Monica.jpg,pieFS5.bmp,Monica just received a huge cash settlement,1,resources,766666,769000,2334,q,1
217173,46,5,1,9,10,f,Joanna.jpg,pieFS5.bmp,Joanna takes discarded food from grocery stores to feed her children.,2,na,781216,782480,1264,q,1
217173,47,5,1,9,10,f,Kelly.jpg,pieFS5.bmp,Kelly steals her coworkers' tips to buy alcohol.,1,reputation,794685,797080,2395,p,0
217173,48,3,3,7,10,f,Sharon.jpg,pieFS3.bmp,Sharon claims false expenses for her reportable work travel.,1,reputation,809286,810441,1155,q,1
217173,49,2,6,9,15,m,Tony.jpg,pieFS2.bmp,Tony just found $50 on the street,1,resources,822654,824121,1467,q,1
217173,50,4,1,4,5,m,Nick.jpg,pieFS4.bmp,Nick is homeless,2,na,836322,838201,1879,q,1
217173,51,1,8,8,16,m,Ian.jpg,pieFS1.bmp,Ian is saving to pay his university fees,2,na,850407,852362,1955,q,1
217173,52,4,4,16,20,m,Daniel.jpg,pieFS4.bmp,Daniel is a retiree,2,na,864575,865742,1167,q,1
217293,1,5,2,18,20,m,Don.jpg,pieFS5.bmp,Don was injured in a hit-and-run accident and cannot afford his medical bills.,2,na,41753,48181,6428,p,0
217293,2,5,1,9,10,m,Peter.jpg,pieFS5.bmp,Peter was mugged and had his wallet stolen.,2,na,60416,64081,3665,q,1
217293,3,3,2,4,6,f,Louise.jpg,pieFS3.bmp,Louise works as a cleaner in a hotel,2,na,76332,80501,4169,q,1
217293,4,4,4,16,20,f,Emily.jpg,pieFS4.bmp,Emily got a large cash bonus from her boss,1,resources,92713,98382,5669,q,1
217293,5,2,7,10,17,f,Monica.jpg,pieFS2.bmp,Monica was a victim of identity theft and is now thousands of dollars in debt.,2,na,110627,118882,8255,q,1
217293,6,3,3,7,10,f,Kay.jpg,pieFS3.bmp,Kay's husband is a wealthy investment banker,1,resources,131121,136622,5501,p,0
217293,7,3,3,7,10,f,Mary.jpg,pieFS3.bmp,Mary can't afford to pay her medical bills,2,na,148851,152643,3792,q,1
217293,8,3,2,4,6,f,Jean.jpg,pieFS3.bmp,Jean works two waitressing jobs to pay her bills.,2,na,164867,167403,2536,q,1
217293,9,4,3,12,15,m,Ricky.jpg,pieFS4.bmp,Ricky just bought an expensive sports car,1,resources,179617,182103,2486,p,0
217293,10,2,3,4,7,f,Marny.jpg,pieFS2.bmp,Marny just received a huge cash settlement,1,resources,194334,196923,2589,p,0
217293,11,3,4,9,13,m,Ian.jpg,pieFS3.bmp,Ian often goes through and steals the neighbors' mail.,1,reputation,209134,213124,3990,p,0
217293,12,5,1,9,10,f,Miriam.jpg,pieFS5.bmp,Miriam is going to be evicted because she is behind on her rent,2,na,225350,228944,3594,q,1
217293,13,4,2,8,10,f,Cindy.jpg,pieFS4.bmp,Cindy takes discarded food from grocery stores to feed her children.,2,na,241165,243844,2679,q,1
217293,14,1,5,5,10,f,Jenny.jpg,pieFS1.bmp,Jenny steals her coworkers' tips to buy alcohol.,1,reputation,256082,259484,3402,p,0
217293,15,1,10,10,20,f,Eileen.jpg,pieFS1.bmp,Eileen just lost her small business after a franchise moved in next door.,2,na,271698,274865,3167,q,1
217293,16,2,8,12,20,f,Sammy.jpg,pieFS2.bmp,Sammy used her mother's social security number to open a credit card account.,1,reputation,287081,290565,3484,p,0
217293,17,5,2,18,20,m,Justin.jpg,pieFS5.bmp,Justin is saving for his son's operation,2,na,302797,306345,3548,q,1
217293,18,4,2,8,10,m,George.jpg,pieFS4.bmp,George bullies his employees to put in extra hours at work.,1,reputation,318613,322446,3833,p,0
217293,19,5,2,18,20,f,Trish.jpg,pieFS5.bmp,Trish owns an international company,1,resources,334695,338226,3531,p,0
217293,20,3,5,11,16,m,Sam.jpg,pieFS3.bmp,Sam has been unable to find a job for over a year.,2,na,350461,352526,2065,q,1
217293,21,2,3,4,7,m,Saul.jpg,pieFS2.bmp,Saul lost his house in a fire,2,na,364728,367567,2839,q,1
217293,22,4,3,12,15,m,Taymar.jpg,pieFS4.bmp,Taymar just lost his job,2,na,379795,381967,2172,q,1
217293,23,3,4,9,13,m,Paul.jpg,pieFS3.bmp,Paul employs illegal immigrants and pays them less than minimum wage.,1,reputation,394196,397507,3311,p,0
217293,24,5,2,18,20,m,Brad.jpg,pieFS5.bmp,Brad just found $50 on the street,1,resources,409728,414167,4439,p,0
217293,25,3,5,11,16,f,Sharon.jpg,pieFS3.bmp,Sharon received a large inheritance from a distant relative,1,resources,426376,429488,3112,p,0
217293,26,3,2,4,6,f,Lauren.jpg,pieFS3.bmp,Lauren is raising money to buy gifts for children in need.,2,na,441693,444888,3195,q,1
217293,27,3,6,14,20,m,Kevin.jpg,pieFS3.bmp,Kevin is homeless,2,na,457092,459608,2516,q,1
217293,28,1,8,8,16,m,Alan.jpg,pieFS1.bmp,Alan could not afford his mortgage and his home was foreclosed.,2,na,471809,474829,3020,q,1
217293,29,5,1,9,10,m,Darnell.jpg,pieFS5.bmp,Darnell is saving to pay his university fees,2,na,487059,488809,1750,q,1
217293,30,5,1,9,10,f,Kelly.jpg,pieFS5.bmp,Kelly illegally parks in the disabled parking spots when she can.,1,reputation,501010,504149,3139,p,0
217293,31,4,3,12,15,f,Beth.jpg,pieFS4.bmp,Beth is a single mother,2,na,516360,520670,4310,q,1
217293,32,4,1,4,5,m,Jared.jpg,pieFS4.bmp,Jared is hiding his taxable income in Switzerland.,1,reputation,532875,535030,2155,p,0
217293,33,5,2,18,20,m,Michael.jpg,pieFS5.bmp,Michael lives in a luxury penthouse apartment,1,resources,547242,548970,1728,p,0
217293,34,5,1,9,10,m,Tony.jpg,pieFS5.bmp,Tony stole money from his mother's wallet.,1,reputation,561194,564250,3056,p,0
217293,35,4,3,12,15,f,Emma.jpg,pieFS4.bmp,Emma just won the lottery,1,resources,576477,579391,2914,p,0
217293,36,4,1,4,5,f,Joanna.jpg,pieFS4.bmp,Joanna's car with her bag and credit cards was recently stolen.,2,na,591593,593971,2378,q,1
217293,37,3,6,14,20,m,Jack.jpg,pieFS3.bmp,Jack lost his life savings when his small business failed,2,na,606177,607891,1714,q,1
217293,38,3,4,9,13,m,Nick.jpg,pieFS3.bmp,Nick cheated on his taxes and is now under investigation for tax fraud.,1,reputation,620095,623531,3436,p,0
217293,39,5,1,9,10,f,Fay.jpg,pieFS5.bmp,Fay cannot afford to send her son to college.,2,na,635761,639532,3771,p,0
217293,40,2,6,9,15,m,Edward.jpg,pieFS2.bmp,Edward underreports his company's earnings and pockets the profits.,1,reputation,651743,655312,3569,p,0
217293,41,5,1,9,10,f,Arianna.jpg,pieFS5.bmp,Arianna regularly fires employees to avoid promoting them.,1,reputation,667542,669192,1650,p,0
217293,42,4,2,8,10,f,Jackie.jpg,pieFS4.bmp,Jackie just found out that her husband has incurred a large credit card debt.,2,na,681410,687653,6243,q,1
217293,43,4,4,16,20,m,Stuart.jpg,pieFS4.bmp,Stuart is a veteran having trouble finding employment.,2,na,699856,703853,3997,q,1
217293,44,3,2,4,6,f,Deborah.jpg,pieFS3.bmp,Deborah is a highly paid actress,1,resources,716072,718853,2781,p,0
217293,45,4,4,16,20,f,Fiona.jpg,pieFS4.bmp,Fiona secretly gambles with her husband's savings.,1,reputation,731055,733873,2818,p,0
217293,46,1,9,9,18,m,Ben.jpg,pieFS1.bmp,Ben stole his elderly father's prescription medications.,1,reputation,746105,750774,4669,p,0
217293,47,5,1,9,10,f,Maria.jpg,pieFS5.bmp,Maria has to take an unpaid leave of absence because her mother broke her hip.,2,na,763020,765554,2534,q,1
217293,48,4,1,4,5,m,Mark.jpg,pieFS4.bmp,Mark declared bankruptcy after he was laid off.,2,na,777836,780034,2198,q,1
217293,49,4,2,8,10,m,Daniel.jpg,pieFS4.bmp,Daniel is a well paid lawyer,1,resources,792304,794115,1811,p,0
217293,50,2,6,9,15,m,Joe.jpg,pieFS2.bmp,Joe is a retiree,2,na,806371,809435,3064,q,1
217293,51,3,3,7,10,m,Matt.jpg,pieFS3.bmp,Matt takes valuables from his friends' homes when asked to house-sit.,1,reputation,821671,824455,2784,p,0
217293,52,5,1,9,10,f,Janet.jpg,pieFS5.bmp,Janet claims false expenses for her reportable work travel.,1,reputation,836688,840255,3567,p,0
217487,1,1,9,9,18,m,Paul.jpg,pieFS1.bmp,Paul employs illegal immigrants and pays them less than minimum wage.,1,reputation,491992,498393,6401,p,0
217487,2,4,4,16,20,f,Maria.jpg,pieFS4.bmp,Maria is a highly paid actress,1,resources,510588,512074,1486,p,0
217487,3,4,2,8,10,f,Louise.jpg,pieFS4.bmp,Louise can't afford to pay her medical bills,2,na,524256,525594,1338,q,1
217487,4,3,3,7,10,f,Cindy.jpg,pieFS3.bmp,Cindy has to take an unpaid leave of absence because her mother broke her hip.,2,na,537774,539034,1260,q,1
217487,5,5,1,9,10,m,Saul.jpg,pieFS5.bmp,Saul often goes through and steals the neighbors' mail.,1,reputation,551226,553195,1969,p,0
217487,6,2,8,12,20,f,Jenny.jpg,pieFS2.bmp,Jenny got a large cash bonus from her boss,1,resources,565394,567155,1761,q,1
217487,7,3,6,14,20,m,Tony.jpg,pieFS3.bmp,Tony has been unable to find a job for over a year.,2,na,579345,581475,2130,q,1
217487,8,3,2,4,6,f,Kay.jpg,pieFS3.bmp,Kay is going to be evicted because she is behind on her rent,2,na,593629,595036,1407,q,1
217487,9,5,1,9,10,m,Ian.jpg,pieFS5.bmp,Ian lost his house in a fire,2,na,607198,609976,2778,p,0
217487,10,3,2,4,6,f,Marny.jpg,pieFS3.bmp,Marny was a victim of identity theft and is now thousands of dollars in debt.,2,na,622165,624656,2491,q,1
217487,11,3,4,9,13,m,Nick.jpg,pieFS3.bmp,Nick just found $50 on the street,1,resources,636815,638637,1822,q,1
217487,12,2,3,4,7,m,Joe.jpg,pieFS2.bmp,Joe could not afford his mortgage and his home was foreclosed.,2,na,650800,652537,1737,q,1
217487,13,3,2,4,6,f,Jackie.jpg,pieFS3.bmp,Jackie works two waitressing jobs to pay her bills.,2,na,664734,667458,2724,q,1
217487,14,4,3,12,15,m,George.jpg,pieFS4.bmp,George is hiding his taxable income in Switzerland.,1,reputation,679618,681438,1820,p,0
217487,15,4,1,4,5,m,Ricky.jpg,pieFS4.bmp,Ricky underreports his company's earnings and pockets the profits.,1,reputation,693603,694998,1395,p,0
217487,16,4,4,16,20,f,Kelly.jpg,pieFS4.bmp,Kelly just received a huge cash settlement,1,resources,707154,708679,1525,p,0
217487,17,3,3,7,10,m,Taymar.jpg,pieFS3.bmp,Taymar is a well paid lawyer,1,resources,720839,722519,1680,q,1
217487,18,5,2,18,20,m,Ben.jpg,pieFS5.bmp,Ben is homeless,2,na,734674,736099,1425,q,1
217487,19,5,1,9,10,f,Janet.jpg,pieFS5.bmp,Janet owns an international company,1,resources,748259,750860,2601,p,0
217487,20,1,8,8,16,m,Stuart.jpg,pieFS1.bmp,Stuart is saving to pay his university fees,2,na,763043,764960,1917,q,1
217487,21,2,7,10,17,f,Lauren.jpg,pieFS2.bmp,Lauren takes discarded food from grocery stores to feed her children.,2,na,777161,778860,1699,q,1
217487,22,3,3,7,10,f,Sharon.jpg,pieFS3.bmp,Sharon received a large inheritance from a distant relative,1,resources,791029,798441,7412,p,0
217487,23,5,1,9,10,f,Monica.jpg,pieFS5.bmp,Monica steals her coworkers' tips to buy alcohol.,1,reputation,810624,811641,1017,p,0
217487,24,4,2,8,10,f,Eileen.jpg,pieFS4.bmp,Eileen just lost her small business after a franchise moved in next door.,2,na,823809,825482,1673,q,1
217487,25,3,4,9,13,m,Peter.jpg,pieFS3.bmp,Peter lives in a luxury penthouse apartment,1,resources,837644,839262,1618,p,0
217487,26,4,4,16,20,m,Edward.jpg,pieFS4.bmp,Edward is a retiree,2,na,851412,855582,4170,p,0
217487,27,5,1,9,10,f,Trish.jpg,pieFS5.bmp,Trish is a single mother,2,na,867744,872683,4939,p,0
217487,28,3,2,4,6,f,Fay.jpg,pieFS3.bmp,Fay just won the lottery,1,resources,884842,886843,2001,q,1
217487,29,4,1,4,5,f,Fiona.jpg,pieFS4.bmp,Fiona cannot afford to send her son to college.,2,na,898993,900364,1371,q,1
217487,30,4,3,12,15,f,Arianna.jpg,pieFS4.bmp,Arianna regularly fires employees to avoid promoting them.,1,reputation,912511,913824,1313,p,0
217487,31,4,2,8,10,m,Mark.jpg,pieFS4.bmp,Mark stole money from his mother's wallet.,1,reputation,925980,927564,1584,q,1
217487,32,4,3,12,15,m,Sam.jpg,pieFS4.bmp,Sam lost his life savings when his small business failed,2,na,939715,941565,1850,q,1
217487,33,4,2,8,10,m,Daniel.jpg,pieFS4.bmp,Daniel just bought an expensive sports car,1,resources,953716,955485,1769,p,0
217487,34,5,2,18,20,m,Matt.jpg,pieFS5.bmp,Matt cheated on his taxes and is now under investigation for tax fraud.,1,reputation,967651,969285,1634,p,0
217487,35,5,1,9,10,m,Michael.jpg,pieFS5.bmp,Michael is a veteran having trouble finding employment.,2,na,981435,982806,1371,q,1
217487,36,2,6,9,15,m,Kevin.jpg,pieFS2.bmp,Kevin stole his elderly father's prescription medications.,1,reputation,994954,997686,2732,q,1
217487,37,2,6,9,15,m,Brad.jpg,pieFS2.bmp,Brad declared bankruptcy after he was laid off.,2,na,1009837,1011547,1710,q,1
217487,38,5,2,18,20,f,Miriam.jpg,pieFS5.bmp,Miriam secretly gambles with her husband's savings.,1,reputation,1023722,1024887,1165,p,0
217487,39,1,5,5,10,f,Deborah.jpg,pieFS1.bmp,Deborah used her mother's social security number to open a credit card account.,1,reputation,1037057,1039607,2550,p,0
217487,40,5,1,9,10,f,Joanna.jpg,pieFS5.bmp,Joanna is raising money to buy gifts for children in need.,2,na,1051758,1053208,1450,q,1
217487,41,2,3,4,7,f,Mary.jpg,pieFS2.bmp,Mary claims false expenses for her reportable work travel.,1,reputation,1065360,1067468,2108,q,1
217487,42,4,3,12,15,f,Emma.jpg,pieFS4.bmp,Emma works as a cleaner in a hotel,2,na,1079627,1082308,2681,p,0
217487,43,3,4,9,13,m,Darnell.jpg,pieFS3.bmp,Darnell takes valuables from his friends' homes when asked to house-sit.,1,reputation,1094461,1096129,1668,q,1
217487,44,3,5,11,16,f,Beth.jpg,pieFS3.bmp,Beth's husband is a wealthy investment banker,1,resources,1108279,1110029,1750,p,0
217487,45,4,1,4,5,m,Justin.jpg,pieFS4.bmp,Justin is saving for his son's operation,2,na,1122180,1125530,3350,q,1
217487,46,5,1,9,10,f,Jean.jpg,pieFS5.bmp,Jean illegally parks in the disabled parking spots when she can.,1,reputation,1137680,1139350,1670,p,0
217487,47,5,2,18,20,m,Alan.jpg,pieFS5.bmp,Alan bullies his employees to put in extra hours at work.,1,reputation,1151498,1153370,1872,p,0
217487,48,1,10,10,20,f,Sammy.jpg,pieFS1.bmp,Sammy's car with her bag and credit cards was recently stolen.,2,na,1165566,1168911,3345,q,1
217487,49,3,5,11,16,m,Jared.jpg,pieFS3.bmp,Jared just lost his job,2,na,1181099,1183351,2252,q,1
217487,50,3,6,14,20,m,Don.jpg,pieFS3.bmp,Don was injured in a hit-and-run accident and cannot afford his medical bills.,2,na,1195533,1197892,2359,q,1
217487,51,5,2,18,20,m,Jack.jpg,pieFS5.bmp,Jack was mugged and had his wallet stolen.,2,na,1210050,1213172,3122,p,0
217487,52,5,1,9,10,f,Emily.jpg,pieFS5.bmp,Emily just found out that her husband has incurred a large credit card debt.,2,na,1225350,1228132,2782,p,0
217514,1,3,2,4,6,f,Lauren.jpg,pieFS3.bmp,Lauren just found out that her husband has incurred a large credit card debt.,2,na,51903,59127,7224,q,1
217514,2,2,8,12,20,f,Beth.jpg,pieFS2.bmp,Beth received a large inheritance from a distant relative,1,resources,71332,76408,5076,q,1
217514,3,3,5,11,16,f,Marny.jpg,pieFS3.bmp,Marny is a highly paid actress,1,resources,88596,92408,3812,q,1
217514,4,3,3,7,10,m,Ben.jpg,pieFS3.bmp,Ben stole his elderly father's prescription medications.,1,reputation,104612,113529,8917,p,0
217514,5,4,3,12,15,f,Fiona.jpg,pieFS4.bmp,Fiona is a single mother,2,na,125705,128189,2484,q,1
217514,6,3,2,4,6,f,Emily.jpg,pieFS3.bmp,Emily has to take an unpaid leave of absence because her mother broke her hip.,2,na,140356,143349,2993,q,1
217514,7,3,2,4,6,f,Jenny.jpg,pieFS3.bmp,Jenny got a large cash bonus from her boss,1,resources,155539,159170,3631,q,1
217514,8,3,6,14,20,m,Matt.jpg,pieFS3.bmp,Matt declared bankruptcy after he was laid off.,2,na,171322,174970,3648,q,1
217514,9,5,2,18,20,m,Mark.jpg,pieFS5.bmp,Mark takes valuables from his friends' homes when asked to house-sit.,1,reputation,187138,191051,3913,p,0
217514,10,4,3,12,15,m,Edward.jpg,pieFS4.bmp,Edward is saving for his son's operation,2,na,203220,205611,2391,q,1
217514,11,1,9,9,18,m,Paul.jpg,pieFS1.bmp,Paul bullies his employees to put in extra hours at work.,1,reputation,217804,220571,2767,q,1
217514,12,1,8,8,16,m,Kevin.jpg,pieFS1.bmp,Kevin was injured in a hit-and-run accident and cannot afford his medical bills.,2,na,232771,237172,4401,q,1
217514,13,4,1,4,5,f,Deborah.jpg,pieFS4.bmp,Deborah was a victim of identity theft and is now thousands of dollars in debt.,2,na,249369,251972,2603,q,1
217514,14,5,2,18,20,m,Taymar.jpg,pieFS5.bmp,Taymar just lost his job,2,na,264136,267573,3437,q,1
217514,15,4,1,4,5,m,Ian.jpg,pieFS4.bmp,Ian was mugged and had his wallet stolen.,2,na,279752,282293,2541,q,1
217514,16,2,3,4,7,f,Emma.jpg,pieFS2.bmp,Emma just won the lottery,1,resources,294453,297113,2660,q,1
217514,17,3,4,9,13,m,Sam.jpg,pieFS3.bmp,Sam often goes through and steals the neighbors' mail.,1,reputation,309270,312954,3684,p,0
217514,18,4,2,8,10,m,Ricky.jpg,pieFS4.bmp,Ricky employs illegal immigrants and pays them less than minimum wage.,1,reputation,325119,331414,6295,p,0
217514,19,5,1,9,10,m,George.jpg,pieFS5.bmp,George could not afford his mortgage and his home was foreclosed.,2,na,343582,346095,2513,q,1
217514,20,1,10,10,20,f,Maria.jpg,pieFS1.bmp,Maria works two waitressing jobs to pay her bills.,2,na,358249,360415,2166,q,1
217514,21,4,2,8,10,m,Daniel.jpg,pieFS4.bmp,Daniel is hiding his taxable income in Switzerland.,1,reputation,372567,378776,6209,q,1
217514,22,2,7,10,17,f,Kay.jpg,pieFS2.bmp,Kay cannot afford to send her son to college.,2,na,390946,394336,3390,q,1
217514,23,5,2,18,20,m,Don.jpg,pieFS5.bmp,Don has been unable to find a job for over a year.,2,na,406496,409196,2700,q,1
217514,24,5,1,9,10,f,Sharon.jpg,pieFS5.bmp,Sharon regularly fires employees to avoid promoting them.,1,reputation,421346,424797,3451,p,0
217514,25,1,5,5,10,f,Cindy.jpg,pieFS1.bmp,Cindy just received a huge cash settlement,1,resources,436946,439097,2151,q,1
217514,26,2,6,9,15,m,Peter.jpg,pieFS2.bmp,Peter lost his house in a fire,2,na,451263,453578,2315,q,1
217514,27,5,1,9,10,f,Trish.jpg,pieFS5.bmp,Trish secretly gambles with her husband's savings.,1,reputation,465731,468818,3087,p,0
217514,28,3,4,9,13,m,Joe.jpg,pieFS3.bmp,Joe underreports his company's earnings and pockets the profits.,1,reputation,480980,485578,4598,q,1
217514,29,3,3,7,10,f,Mary.jpg,pieFS3.bmp,Mary claims false expenses for her reportable work travel.,1,reputation,497729,500619,2890,p,0
217514,30,3,4,9,13,m,Darnell.jpg,pieFS3.bmp,Darnell just found $50 on the street,1,resources,512795,516499,3704,q,1
217514,31,4,1,4,5,m,Justin.jpg,pieFS4.bmp,Justin is a well paid lawyer,1,resources,528694,533220,4526,q,1
217514,32,2,3,4,7,m,Jared.jpg,pieFS2.bmp,Jared is a retiree,2,na,545409,547720,2311,q,1
217514,33,5,1,9,10,f,Arianna.jpg,pieFS5.bmp,Arianna works as a cleaner in a hotel,2,na,559877,562000,2123,q,1
217514,34,5,1,9,10,m,Jack.jpg,pieFS5.bmp,Jack is homeless,2,na,574161,576501,2340,q,1
217514,35,5,2,18,20,f,Janet.jpg,pieFS5.bmp,Janet's husband is a wealthy investment banker,1,resources,588662,594601,5939,p,0
217514,36,5,1,9,10,f,Jean.jpg,pieFS5.bmp,Jean takes discarded food from grocery stores to feed her children.,2,na,606759,609281,2522,q,1
217514,37,4,3,12,15,m,Alan.jpg,pieFS4.bmp,Alan just bought an expensive sports car,1,resources,621442,626302,4860,q,1
217514,38,3,6,14,20,m,Saul.jpg,pieFS3.bmp,Saul is saving to pay his university fees,2,na,638457,640602,2145,q,1
217514,39,4,4,16,20,f,Sammy.jpg,pieFS4.bmp,Sammy steals her coworkers' tips to buy alcohol.,1,reputation,652758,655963,3205,p,0
217514,40,5,2,18,20,m,Michael.jpg,pieFS5.bmp,Michael lives in a luxury penthouse apartment,1,resources,668124,674283,6159,q,1
217514,41,3,3,7,10,f,Louise.jpg,pieFS3.bmp,Louise can't afford to pay her medical bills,2,na,686437,688524,2087,q,1
217514,42,3,2,4,6,f,Eileen.jpg,pieFS3.bmp,Eileen just lost her small business after a franchise moved in next door.,2,na,700688,705224,4536,q,1
217514,43,2,6,9,15,m,Stuart.jpg,pieFS2.bmp,Stuart stole money from his mother's wallet.,1,reputation,717387,720965,3578,p,0
217514,44,3,5,11,16,m,Brad.jpg,pieFS3.bmp,Brad lost his life savings when his small business failed,2,na,733152,735225,2073,q,1
217514,45,4,4,16,20,f,Monica.jpg,pieFS4.bmp,Monica used her mother's social security number to open a credit card account.,1,reputation,747403,753185,5782,q,1
217514,46,4,2,8,10,f,Kelly.jpg,pieFS4.bmp,Kelly is raising money to buy gifts for children in need.,2,na,765384,767246,1862,q,1
217514,47,5,1,9,10,f,Joanna.jpg,pieFS5.bmp,Joanna illegally parks in the disabled parking spots when she can.,1,reputation,779435,783826,4391,p,0
217514,48,5,1,9,10,m,Nick.jpg,pieFS5.bmp,Nick cheated on his taxes and is now under investigation for tax fraud.,1,reputation,796000,801987,5987,p,0
217514,49,5,1,9,10,f,Fay.jpg,pieFS5.bmp,Fay is going to be evicted because she is behind on her rent,2,na,814147,816907,2760,q,1
217514,50,4,3,12,15,f,Miriam.jpg,pieFS4.bmp,Miriam owns an international company,1,resources,829063,832587,3524,q,1
217514,51,4,2,8,10,f,Jackie.jpg,pieFS4.bmp,Jackie's car with her bag and credit cards was recently stolen.,2,na,844746,847288,2542,q,1
217514,52,4,4,16,20,m,Tony.jpg,pieFS4.bmp,Tony is a veteran having trouble finding employment.,2,na,859447,861328,1881,q,1
217630,1,3,2,4,6,f,Joanna.jpg,pieFS3.bmp,Joanna was a victim of identity theft and is now thousands of dollars in debt.,2,na,74008,77186,3178,q,1
217630,2,4,3,12,15,f,Janet.jpg,pieFS4.bmp,Janet's husband is a wealthy investment banker,1,resources,89407,93846,4439,q,1
217630,3,3,2,4,6,f,Arianna.jpg,pieFS3.bmp,Arianna can't afford to pay her medical bills,2,na,106055,109006,2951,q,1
217630,4,5,1,9,10,m,Saul.jpg,pieFS5.bmp,Saul was mugged and had his wallet stolen.,2,na,121221,128346,7125,q,1
217630,5,5,2,18,20,m,Michael.jpg,pieFS5.bmp,Michael often goes through and steals the neighbors' mail.,1,reputation,140549,146646,6097,p,0
217630,6,3,3,7,10,f,Emily.jpg,pieFS3.bmp,Emily works two waitressing jobs to pay her bills.,2,na,158862,161526,2664,q,1
217630,7,1,5,5,10,f,Monica.jpg,pieFS1.bmp,Monica just received a huge cash settlement,1,resources,173729,176507,2778,q,1
217630,8,4,1,4,5,f,Maria.jpg,pieFS4.bmp,Maria takes discarded food from grocery stores to feed her children.,2,na,188695,191066,2371,q,1
217630,9,5,2,18,20,m,Sam.jpg,pieFS5.bmp,Sam has been unable to find a job for over a year.,2,na,203296,205346,2050,q,1
217630,10,5,1,9,10,f,Jean.jpg,pieFS5.bmp,Jean steals her coworkers' tips to buy alcohol.,1,reputation,217563,223946,6383,q,1
217630,11,3,4,9,13,m,Jared.jpg,pieFS3.bmp,Jared underreports his company's earnings and pockets the profits.,1,reputation,236159,239546,3387,q,1
217630,12,4,2,8,10,m,Justin.jpg,pieFS4.bmp,Justin is a well paid lawyer,1,resources,251741,254347,2606,q,1
217630,13,5,1,9,10,f,Kay.jpg,pieFS5.bmp,Kay is going to be evicted because she is behind on her rent,2,na,266558,269147,2589,q,1
217630,14,4,2,8,10,f,Kelly.jpg,pieFS4.bmp,Kelly just lost her small business after a franchise moved in next door.,2,na,281341,283067,1726,q,1
217630,15,2,6,9,15,m,Daniel.jpg,pieFS2.bmp,Daniel is a retiree,2,na,295259,297347,2088,q,1
217630,16,5,1,9,10,m,Ricky.jpg,pieFS5.bmp,Ricky just bought an expensive sports car,1,resources,309559,311127,1568,q,1
217630,17,3,2,4,6,f,Louise.jpg,pieFS3.bmp,Louise owns an international company,1,resources,323311,325227,1916,q,1
217630,18,2,8,12,20,f,Trish.jpg,pieFS2.bmp,Trish received a large inheritance from a distant relative,1,resources,337428,339847,2419,q,1
217630,19,2,3,4,7,m,Kevin.jpg,pieFS2.bmp,Kevin lost his house in a fire,2,na,352062,354247,2185,q,1
217630,20,5,1,9,10,f,Deborah.jpg,pieFS5.bmp,Deborah used her mother's social security number to open a credit card account.,1,reputation,366479,369267,2788,p,0
217630,21,1,10,10,20,f,Beth.jpg,pieFS1.bmp,Beth is a single mother,2,na,381512,383807,2295,q,1
217630,22,2,6,9,15,m,Don.jpg,pieFS2.bmp,Don just found $50 on the street,1,resources,396029,398627,2598,q,1
217630,23,5,1,9,10,f,Fay.jpg,pieFS5.bmp,Fay just won the lottery,1,resources,410845,413487,2642,q,1
217630,24,4,3,12,15,f,Sammy.jpg,pieFS4.bmp,Sammy is raising money to buy gifts for children in need.,2,na,425695,428367,2672,q,1
217630,25,3,6,14,20,m,George.jpg,pieFS3.bmp,George is saving for his son's operation,2,na,440562,442548,1986,q,1
217630,26,1,8,8,16,m,Matt.jpg,pieFS1.bmp,Matt is homeless,2,na,454763,456588,1825,q,1
217630,27,5,1,9,10,f,Emma.jpg,pieFS5.bmp,Emma cannot afford to send her son to college.,2,na,468797,471088,2291,q,1
217630,28,5,2,18,20,m,Stuart.jpg,pieFS5.bmp,Stuart is saving to pay his university fees,2,na,483297,485488,2191,q,1
217630,29,3,3,7,10,f,Cindy.jpg,pieFS3.bmp,Cindy illegally parks in the disabled parking spots when she can.,1,reputation,497698,501028,3330,p,0
217630,30,4,1,4,5,m,Peter.jpg,pieFS4.bmp,Peter lives in a luxury penthouse apartment,1,resources,513231,515588,2357,q,1
217630,31,1,9,9,18,m,Paul.jpg,pieFS1.bmp,Paul bullies his employees to put in extra hours at work.,1,reputation,527781,532208,4427,p,0
217630,32,5,1,9,10,f,Marny.jpg,pieFS5.bmp,Marny's car with her bag and credit cards was recently stolen.,2,na,544412,546368,1956,q,1
217630,33,4,1,4,5,m,Joe.jpg,pieFS4.bmp,Joe just lost his job,2,na,558579,561228,2649,q,1
217630,34,4,2,8,10,f,Jackie.jpg,pieFS4.bmp,Jackie just found out that her husband has incurred a large credit card debt.,2,na,573446,576148,2702,q,1
217630,35,3,4,9,13,m,Jack.jpg,pieFS3.bmp,Jack stole money from his mother's wallet.,1,reputation,588363,591648,3285,p,0
217630,36,5,1,9,10,m,Ian.jpg,pieFS5.bmp,Ian lost his life savings when his small business failed,2,na,603862,608808,4946,q,1
217630,37,5,2,18,20,f,Mary.jpg,pieFS5.bmp,Mary regularly fires employees to avoid promoting them.,1,reputation,621026,623588,2562,p,0
217630,38,4,2,8,10,m,Edward.jpg,pieFS4.bmp,Edward employs illegal immigrants and pays them less than minimum wage.,1,reputation,635793,638628,2835,p,0
217630,39,3,6,14,20,m,Alan.jpg,pieFS3.bmp,Alan could not afford his mortgage and his home was foreclosed.,2,na,650842,652848,2006,q,1
217630,40,4,3,12,15,m,Mark.jpg,pieFS4.bmp,Mark cheated on his taxes and is now under investigation for tax fraud.,1,reputation,665043,667548,2505,p,0
217630,41,4,4,16,20,f,Miriam.jpg,pieFS4.bmp,Miriam secretly gambles with her husband's savings.,1,reputation,679760,682329,2569,p,0
217630,42,4,3,12,15,m,Brad.jpg,pieFS4.bmp,Brad is a veteran having trouble finding employment.,2,na,694526,696869,2343,q,1
217630,43,5,2,18,20,m,Tony.jpg,pieFS5.bmp,Tony stole his elderly father's prescription medications.,1,reputation,709077,711549,2472,p,0
217630,44,4,4,16,20,m,Nick.jpg,pieFS4.bmp,Nick declared bankruptcy after he was laid off.,2,na,723760,725909,2149,q,1
217630,45,3,5,11,16,f,Jenny.jpg,pieFS3.bmp,Jenny is a highly paid actress,1,resources,738127,740329,2202,q,1
217630,46,2,7,10,17,f,Lauren.jpg,pieFS2.bmp,Lauren has to take an unpaid leave of absence because her mother broke her hip.,2,na,752545,756769,4224,q,1
217630,47,3,3,7,10,m,Taymar.jpg,pieFS3.bmp,Taymar is hiding his taxable income in Switzerland.,1,reputation,768959,774189,5230,q,1
217630,48,2,3,4,7,f,Sharon.jpg,pieFS2.bmp,Sharon claims false expenses for her reportable work travel.,1,reputation,786390,793389,6999,q,1
217630,49,3,4,9,13,m,Ben.jpg,pieFS3.bmp,Ben takes valuables from his friends' homes when asked to house-sit.,1,reputation,805602,809969,4367,p,0
217630,50,3,5,11,16,m,Darnell.jpg,pieFS3.bmp,Darnell was injured in a hit-and-run accident and cannot afford his medical bills.,2,na,822166,826029,3863,q,1
217630,51,4,4,16,20,f,Eileen.jpg,pieFS4.bmp,Eileen got a large cash bonus from her boss,1,resources,838215,841029,2814,q,1
217630,52,3,2,4,6,f,Fiona.jpg,pieFS3.bmp,Fiona works as a cleaner in a hotel,2,na,853231,855809,2578,q,1
217719,1,5,1,9,10,f,Kay.jpg,pieFS5.bmp,Kay is a single mother,2,na,36862,42079,5217,q,1
217719,2,4,2,8,10,f,Deborah.jpg,pieFS4.bmp,Deborah just lost her small business after a franchise moved in next door.,2,na,54268,59474,5206,q,1
217719,3,4,1,4,5,m,Sam.jpg,pieFS4.bmp,Sam lost his life savings when his small business failed,2,na,71658,75640,3982,q,1
217719,4,3,2,4,6,f,Marny.jpg,pieFS3.bmp,Marny used her mother's social security number to open a credit card account.,1,reputation,87827,93190,5363,p,0
217719,5,1,9,9,18,m,Jack.jpg,pieFS1.bmp,Jack cheated on his taxes and is now under investigation for tax fraud.,1,reputation,105384,109577,4193,p,0
217719,6,4,1,4,5,f,Kelly.jpg,pieFS4.bmp,Kelly is raising money to buy gifts for children in need.,2,na,121787,125152,3365,q,1
217719,7,5,1,9,10,f,Arianna.jpg,pieFS5.bmp,Arianna just won the lottery,1,resources,137337,141113,3776,p,0
217719,8,3,6,14,20,m,Saul.jpg,pieFS3.bmp,Saul is a veteran having trouble finding employment.,2,na,153306,156525,3219,p,0
217719,9,5,1,9,10,m,Daniel.jpg,pieFS5.bmp,Daniel is hiding his taxable income in Switzerland.,1,reputation,168722,176657,7935,p,0
217719,10,2,3,4,7,f,Maria.jpg,pieFS2.bmp,Maria illegally parks in the disabled parking spots when she can.,1,reputation,188854,191886,3032,p,0
217719,11,3,4,9,13,m,Michael.jpg,pieFS3.bmp,Michael stole his elderly father's prescription medications.,1,reputation,204087,206510,2423,p,0
217719,12,3,2,4,6,f,Fay.jpg,pieFS3.bmp,Fay cannot afford to send her son to college.,2,na,218701,224754,6053,q,1
217719,13,4,3,12,15,m,George.jpg,pieFS4.bmp,George underreports his company's earnings and pockets the profits.,1,reputation,236944,240161,3217,p,0
217719,14,3,2,4,6,f,Emily.jpg,pieFS3.bmp,Emily's car with her bag and credit cards was recently stolen.,2,na,252344,257209,4865,p,0
217719,15,5,1,9,10,m,Tony.jpg,pieFS5.bmp,Tony declared bankruptcy after he was laid off.,2,na,269416,273952,4536,p,0
217719,16,5,1,9,10,f,Fiona.jpg,pieFS5.bmp,Fiona regularly fires employees to avoid promoting them.,1,reputation,286153,288801,2648,p,0
217719,17,3,3,7,10,f,Joanna.jpg,pieFS3.bmp,Joanna just found out that her husband has incurred a large credit card debt.,2,na,301001,305277,4276,p,0
217719,18,2,6,9,15,m,Brad.jpg,pieFS2.bmp,Brad takes valuables from his friends' homes when asked to house-sit.,1,reputation,317455,324051,6596,p,0
217719,19,5,2,18,20,m,Peter.jpg,pieFS5.bmp,Peter was injured in a hit-and-run accident and cannot afford his medical bills.,2,na,336249,340905,4656,q,1
217719,20,2,6,9,15,m,Ben.jpg,pieFS2.bmp,Ben was mugged and had his wallet stolen.,2,na,353087,356894,3807,q,1
217719,21,2,8,12,20,f,Jackie.jpg,pieFS2.bmp,Jackie is a highly paid actress,1,resources,369072,372592,3520,p,0
217719,22,4,3,12,15,f,Cindy.jpg,pieFS4.bmp,Cindy has to take an unpaid leave of absence because her mother broke her hip.,2,na,384790,390293,5503,q,1
217719,23,4,2,8,10,m,Mark.jpg,pieFS4.bmp,Mark often goes through and steals the neighbors' mail.,1,reputation,402464,408347,5883,p,0
217719,24,4,1,4,5,m,Jared.jpg,pieFS4.bmp,Jared is a well paid lawyer,1,resources,420539,423417,2878,q,1
217719,25,1,8,8,16,m,Ricky.jpg,pieFS1.bmp,Ricky is a retiree,2,na,435605,439846,4241,q,1
217719,26,3,5,11,16,f,Monica.jpg,pieFS3.bmp,Monica got a large cash bonus from her boss,1,resources,452058,454658,2600,p,0
217719,27,4,3,12,15,m,Don.jpg,pieFS4.bmp,Don has been unable to find a job for over a year.,2,na,466856,470519,3663,q,1
217719,28,4,2,8,10,f,Lauren.jpg,pieFS4.bmp,Lauren was a victim of identity theft and is now thousands of dollars in debt.,2,na,482691,487750,5059,q,1
217719,29,3,5,11,16,m,Kevin.jpg,pieFS3.bmp,Kevin lost his house in a fire,2,na,499947,507419,7472,q,1
217719,30,5,1,9,10,f,Beth.jpg,pieFS5.bmp,Beth secretly gambles with her husband's savings.,1,reputation,519610,525699,6089,p,0
217719,31,1,5,5,10,f,Sharon.jpg,pieFS1.bmp,Sharon claims false expenses for her reportable work travel.,1,reputation,537886,541725,3839,p,0
217719,32,5,2,18,20,m,Darnell.jpg,pieFS5.bmp,Darnell just found $50 on the street,1,resources,553922,561735,7813,q,1
217719,33,5,1,9,10,f,Eileen.jpg,pieFS5.bmp,Eileen works two waitressing jobs to pay her bills.,2,na,573903,578853,4950,q,1
217719,34,3,4,9,13,m,Alan.jpg,pieFS3.bmp,Alan just bought an expensive sports car,1,resources,591025,595221,4196,q,1
217719,35,5,1,9,10,m,Taymar.jpg,pieFS5.bmp,Taymar is saving for his son's operation,2,na,607378,614103,6725,q,1
217719,36,1,10,10,20,f,Emma.jpg,pieFS1.bmp,Emma works as a cleaner in a hotel,2,na,626290,630676,4386,p,0
217719,37,5,2,18,20,f,Janet.jpg,pieFS5.bmp,Janet's husband is a wealthy investment banker,1,resources,642877,645883,3006,p,0
217719,38,5,2,18,20,m,Paul.jpg,pieFS5.bmp,Paul bullies his employees to put in extra hours at work.,1,reputation,658076,662264,4188,p,0
217719,39,2,7,10,17,f,Miriam.jpg,pieFS2.bmp,Miriam can't afford to pay her medical bills,2,na,674462,678131,3669,p,0
217719,40,4,3,12,15,f,Jean.jpg,pieFS4.bmp,Jean just received a huge cash settlement,1,resources,690331,693825,3494,p,0
217719,41,5,1,9,10,f,Sammy.jpg,pieFS5.bmp,Sammy takes discarded food from grocery stores to feed her children.,2,na,706015,711074,5059,q,1
217719,42,2,3,4,7,m,Matt.jpg,pieFS2.bmp,Matt is homeless,2,na,723271,727629,4358,p,0
217719,43,4,4,16,20,m,Ian.jpg,pieFS4.bmp,Ian is saving to pay his university fees,2,na,739824,743623,3799,q,1
217719,44,3,6,14,20,m,Edward.jpg,pieFS3.bmp,Edward just lost his job,2,na,755826,759578,3752,q,1
217719,45,3,2,4,6,f,Mary.jpg,pieFS3.bmp,Mary is going to be evicted because she is behind on her rent,2,na,771795,775140,3345,p,0
217719,46,3,3,7,10,f,Jenny.jpg,pieFS3.bmp,Jenny steals her coworkers' tips to buy alcohol.,1,reputation,787312,792483,5171,p,0
217719,47,4,2,8,10,m,Stuart.jpg,pieFS4.bmp,Stuart lives in a luxury penthouse apartment,1,resources,804651,807501,2850,q,1
217719,48,3,3,7,10,m,Justin.jpg,pieFS3.bmp,Justin employs illegal immigrants and pays them less than minimum wage.,1,reputation,819667,824845,5178,p,0
217719,49,3,4,9,13,m,Nick.jpg,pieFS3.bmp,Nick stole money from his mother's wallet.,1,reputation,837056,842802,5746,p,0
217719,50,4,4,16,20,f,Louise.jpg,pieFS4.bmp,Louise owns an international company,1,resources,854981,860131,5150,q,1
217719,51,4,4,16,20,f,Trish.jpg,pieFS4.bmp,Trish received a large inheritance from a distant relative,1,resources,872321,877680,5359,p,0
217719,52,5,2,18,20,m,Joe.jpg,pieFS5.bmp,Joe could not afford his mortgage and his home was foreclosed.,2,na,889878,893317,3439,q,1
217909,1,4,3,12,15,f,Kelly.jpg,pieFS4.bmp,Kelly got a large cash bonus from her boss,1,resources,47787,52095,4308,q,1
217909,2,2,6,9,15,m,Brad.jpg,pieFS2.bmp,Brad lives in a luxury penthouse apartment,1,resources,64286,68795,4509,q,1
217909,3,4,1,4,5,m,Alan.jpg,pieFS4.bmp,Alan is hiding his taxable income in Switzerland.,1,reputation,80967,83276,2309,q,1
217909,4,5,2,18,20,m,Peter.jpg,pieFS5.bmp,Peter stole money from his mother's wallet.,1,reputation,95467,100116,4649,q,1
217909,5,1,5,5,10,f,Fiona.jpg,pieFS1.bmp,Fiona owns an international company,1,resources,112299,115136,2837,q,1
217909,6,5,2,18,20,f,Louise.jpg,pieFS5.bmp,Louise received a large inheritance from a distant relative,1,resources,127298,130776,3478,q,1
217909,7,3,4,9,13,m,George.jpg,pieFS3.bmp,George underreports his company's earnings and pockets the profits.,1,reputation,142948,145216,2268,q,1
217909,8,3,4,9,13,m,Joe.jpg,pieFS3.bmp,Joe is a well paid lawyer,1,resources,157365,158677,1312,q,1
217909,9,3,2,4,6,f,Arianna.jpg,pieFS3.bmp,Arianna is a single mother,2,na,170833,174056,3223,q,1
217909,10,5,2,18,20,m,Mark.jpg,pieFS5.bmp,Mark lost his life savings when his small business failed,2,na,186233,189057,2824,q,1
217909,11,5,1,9,10,f,Fay.jpg,pieFS5.bmp,Fay just won the lottery,1,resources,201233,202597,1364,q,1
217909,12,2,6,9,15,m,Daniel.jpg,pieFS2.bmp,Daniel is a retiree,2,na,214751,216097,1346,q,1
217909,13,4,1,4,5,f,Joanna.jpg,pieFS4.bmp,Joanna was a victim of identity theft and is now thousands of dollars in debt.,2,na,228269,230417,2148,q,1
217909,14,1,9,9,18,m,Nick.jpg,pieFS1.bmp,Nick cheated on his taxes and is now under investigation for tax fraud.,1,reputation,242570,243857,1287,q,1
217909,15,3,4,9,13,m,Ricky.jpg,pieFS3.bmp,Ricky just bought an expensive sports car,1,resources,256005,257997,1992,q,1
217909,16,4,2,8,10,f,Eileen.jpg,pieFS4.bmp,Eileen works two waitressing jobs to pay her bills.,2,na,270155,271618,1463,q,1
217909,17,4,2,8,10,f,Trish.jpg,pieFS4.bmp,Trish cannot afford to send her son to college.,2,na,283774,285298,1524,q,1
217909,18,2,8,12,20,f,Jackie.jpg,pieFS2.bmp,Jackie just received a huge cash settlement,1,resources,297458,298638,1180,q,1
217909,19,4,4,16,20,m,Ben.jpg,pieFS4.bmp,Ben is a veteran having trouble finding employment.,2,na,310810,312038,1228,q,1
217909,20,1,10,10,20,f,Maria.jpg,pieFS1.bmp,Maria takes discarded food from grocery stores to feed her children.,2,na,324212,325858,1646,q,1
217909,21,4,2,8,10,m,Sam.jpg,pieFS4.bmp,Sam stole his elderly father's prescription medications.,1,reputation,338013,341678,3665,q,1
217909,22,3,5,11,16,f,Janet.jpg,pieFS3.bmp,Janet regularly fires employees to avoid promoting them.,1,reputation,353829,355379,1550,q,1
217909,23,3,5,11,16,m,Taymar.jpg,pieFS3.bmp,Taymar is saving for his son's operation,2,na,367530,369118,1588,q,1
217909,24,4,4,16,20,f,Sammy.jpg,pieFS4.bmp,Sammy steals her coworkers' tips to buy alcohol.,1,reputation,381265,382899,1634,q,1
217909,25,4,3,12,15,f,Jenny.jpg,pieFS4.bmp,Jenny just lost her small business after a franchise moved in next door.,2,na,395066,396819,1753,q,1
217909,26,4,4,16,20,f,Emma.jpg,pieFS4.bmp,Emma secretly gambles with her husband's savings.,1,reputation,408967,410359,1392,q,1
217909,27,3,6,14,20,m,Jack.jpg,pieFS3.bmp,Jack declared bankruptcy after he was laid off.,2,na,422519,425179,2660,q,1
217909,28,3,3,7,10,m,Edward.jpg,pieFS3.bmp,Edward bullies his employees to put in extra hours at work.,1,reputation,437335,438539,1204,q,1
217909,29,4,1,4,5,m,Justin.jpg,pieFS4.bmp,Justin just lost his job,2,na,450704,452999,2295,q,1
217909,30,3,3,7,10,f,Monica.jpg,pieFS3.bmp,Monica used her mother's social security number to open a credit card account.,1,reputation,465171,466160,989,q,1
217909,31,3,2,4,6,f,Emily.jpg,pieFS3.bmp,Emily is raising money to buy gifts for children in need.,2,na,478306,480900,2594,q,1
217909,32,5,2,18,20,m,Michael.jpg,pieFS5.bmp,Michael takes valuables from his friends' homes when asked to house-sit.,1,reputation,493073,495520,2447,q,1
217909,33,3,6,14,20,m,Don.jpg,pieFS3.bmp,Don was injured in a hit-and-run accident and cannot afford his medical bills.,2,na,507690,509740,2050,q,1
217909,34,5,1,9,10,m,Ian.jpg,pieFS5.bmp,Ian was mugged and had his wallet stolen.,2,na,521924,524360,2436,q,1
217909,35,2,3,4,7,f,Deborah.jpg,pieFS2.bmp,Deborah illegally parks in the disabled parking spots when she can.,1,reputation,536525,538940,2415,q,1
217909,36,4,2,8,10,m,Tony.jpg,pieFS4.bmp,Tony often goes through and steals the neighbors' mail.,1,reputation,551092,552040,948,q,1
217909,37,2,7,10,17,f,Jean.jpg,pieFS2.bmp,Jean's car with her bag and credit cards was recently stolen.,2,na,564194,567181,2987,q,1
217909,38,5,1,9,10,m,Stuart.jpg,pieFS5.bmp,Stuart has been unable to find a job for over a year.,2,na,579343,580961,1618,q,1
217909,39,5,1,9,10,f,Kay.jpg,pieFS5.bmp,Kay claims false expenses for her reportable work travel.,1,reputation,593128,595461,2333,q,1
217909,40,5,1,9,10,f,Beth.jpg,pieFS5.bmp,Beth works as a cleaner in a hotel,2,na,607612,610581,2969,q,1
217909,41,5,2,18,20,m,Kevin.jpg,pieFS5.bmp,Kevin lost his house in a fire,2,na,622812,626142,3330,q,1
217909,42,3,2,4,6,f,Mary.jpg,pieFS3.bmp,Mary's husband is a wealthy investment banker,1,resources,638394,641041,2647,q,1
217909,43,4,3,12,15,m,Saul.jpg,pieFS4.bmp,Saul just found $50 on the street,1,resources,653277,655282,2005,q,1
217909,44,4,3,12,15,m,Darnell.jpg,pieFS4.bmp,Darnell is homeless,2,na,667511,670122,2611,q,1
217909,45,5,1,9,10,f,Lauren.jpg,pieFS5.bmp,Lauren just found out that her husband has incurred a large credit card debt.,2,na,682328,684342,2014,q,1
217909,46,5,1,9,10,f,Marny.jpg,pieFS5.bmp,Marny is a highly paid actress,1,resources,696562,697862,1300,q,1
217909,47,5,1,9,10,m,Paul.jpg,pieFS5.bmp,Paul employs illegal immigrants and pays them less than minimum wage.,1,reputation,710064,711522,1458,q,1
217909,48,3,2,4,6,f,Cindy.jpg,pieFS3.bmp,Cindy has to take an unpaid leave of absence because her mother broke her hip.,2,na,723749,725863,2114,q,1
217909,49,1,8,8,16,m,Matt.jpg,pieFS1.bmp,Matt is saving to pay his university fees,2,na,738066,741263,3197,q,1
217909,50,3,3,7,10,f,Miriam.jpg,pieFS3.bmp,Miriam can't afford to pay her medical bills,2,na,753482,755823,2341,q,1
217909,51,2,3,4,7,m,Jared.jpg,pieFS2.bmp,Jared could not afford his mortgage and his home was foreclosed.,2,na,768032,768863,831,q,1
217909,52,5,1,9,10,f,Sharon.jpg,pieFS5.bmp,Sharon is going to be evicted because she is behind on her rent,2,na,781068,783003,1935,q,1
217988,1,5,2,18,20,m,Joe.jpg,pieFS5.bmp,Joe could not afford his mortgage and his home was foreclosed.,2,na,37257,39693,2436,q,1
217988,2,3,2,4,6,f,Sammy.jpg,pieFS3.bmp,Sammy illegally parks in the disabled parking spots when she can.,1,reputation,51890,53873,1983,q,1
217988,3,3,2,4,6,f,Eileen.jpg,pieFS3.bmp,Eileen's car with her bag and credit cards was recently stolen.,2,na,66024,67973,1949,q,1
217988,4,5,1,9,10,f,Maria.jpg,pieFS5.bmp,Maria just found out that her husband has incurred a large credit card debt.,2,na,80142,80453,311,q,1
217988,5,4,4,16,20,f,Fiona.jpg,pieFS4.bmp,Fiona claims false expenses for her reportable work travel.,1,reputation,92628,97613,4985,p,0
217988,6,1,10,10,20,f,Janet.jpg,pieFS1.bmp,Janet works as a cleaner in a hotel,2,na,109808,110973,1165,q,1
217988,7,4,1,4,5,m,Don.jpg,pieFS4.bmp,Don is saving to pay his university fees,2,na,123127,124133,1006,q,1
217988,8,4,3,12,15,f,Miriam.jpg,pieFS4.bmp,Miriam's husband is a wealthy investment banker,1,resources,136279,137233,954,q,1
217988,9,5,1,9,10,f,Joanna.jpg,pieFS5.bmp,Joanna is a highly paid actress,1,resources,149381,151073,1692,q,1
217988,10,4,1,4,5,f,Kelly.jpg,pieFS4.bmp,Kelly has to take an unpaid leave of absence because her mother broke her hip.,2,na,163248,164293,1045,q,1
217988,11,2,6,9,15,m,Jack.jpg,pieFS2.bmp,Jack lives in a luxury penthouse apartment,1,resources,176450,177413,963,q,1
217988,12,1,5,5,10,f,Monica.jpg,pieFS1.bmp,Monica got a large cash bonus from her boss,1,resources,189569,190573,1004,q,1
217988,13,4,3,12,15,f,Deborah.jpg,pieFS4.bmp,Deborah was a victim of identity theft and is now thousands of dollars in debt.,2,na,202737,203893,1156,q,1
217988,14,5,1,9,10,f,Arianna.jpg,pieFS5.bmp,Arianna can't afford to pay her medical bills,2,na,216056,216913,857,q,1
217988,15,3,3,7,10,m,Taymar.jpg,pieFS3.bmp,Taymar is hiding his taxable income in Switzerland.,1,reputation,229074,231213,2139,q,1
217988,16,4,2,8,10,f,Emma.jpg,pieFS4.bmp,Emma is going to be evicted because she is behind on her rent,2,na,243375,244413,1038,q,1
217988,17,3,3,7,10,f,Louise.jpg,pieFS3.bmp,Louise owns an international company,1,resources,256560,258073,1513,q,1
217988,18,5,2,18,20,m,George.jpg,pieFS5.bmp,George underreports his company's earnings and pockets the profits.,1,reputation,270245,272613,2368,p,0
217988,19,4,2,8,10,f,Lauren.jpg,pieFS4.bmp,Lauren works two waitressing jobs to pay her bills.,2,na,284762,285754,992,q,1
217988,20,5,2,18,20,f,Sharon.jpg,pieFS5.bmp,Sharon received a large inheritance from a distant relative,1,resources,297914,299954,2040,q,1
217988,21,5,1,9,10,f,Fay.jpg,pieFS5.bmp,Fay is a single mother,2,na,312114,314034,1920,q,1
217988,22,4,2,8,10,m,Daniel.jpg,pieFS4.bmp,Daniel is a well paid lawyer,1,resources,326182,327654,1472,q,1
217988,23,2,3,4,7,f,Jean.jpg,pieFS2.bmp,Jean just received a huge cash settlement,1,resources,339816,341174,1358,q,1
217988,24,5,2,18,20,m,Matt.jpg,pieFS5.bmp,Matt stole money from his mother's wallet.,1,reputation,353351,355154,1803,p,0
217988,25,2,3,4,7,m,Michael.jpg,pieFS2.bmp,Michael lost his life savings when his small business failed,2,na,367302,368134,832,q,1
217988,26,4,2,8,10,m,Saul.jpg,pieFS4.bmp,Saul cheated on his taxes and is now under investigation for tax fraud.,1,reputation,380304,382454,2150,p,0
217988,27,5,1,9,10,m,Tony.jpg,pieFS5.bmp,Tony is a veteran having trouble finding employment.,2,na,394605,395474,869,q,1
217988,28,3,6,14,20,m,Justin.jpg,pieFS3.bmp,Justin is a retiree,2,na,407624,408814,1190,q,1
217988,29,3,4,9,13,m,Jared.jpg,pieFS3.bmp,Jared just bought an expensive sports car,1,resources,420975,421714,739,q,1
217988,30,2,7,10,17,f,Emily.jpg,pieFS2.bmp,Emily takes discarded food from grocery stores to feed her children.,2,na,433861,434534,673,q,1
217988,31,3,4,9,13,m,Peter.jpg,pieFS3.bmp,Peter stole his elderly father's prescription medications.,1,reputation,446696,447794,1098,p,0
217988,32,4,4,16,20,f,Cindy.jpg,pieFS4.bmp,Cindy steals her coworkers' tips to buy alcohol.,1,reputation,459948,461274,1326,p,0
217988,33,2,8,12,20,f,Mary.jpg,pieFS2.bmp,Mary just won the lottery,1,resources,473433,474454,1021,q,1
217988,34,5,1,9,10,m,Stuart.jpg,pieFS5.bmp,Stuart declared bankruptcy after he was laid off.,2,na,486601,487794,1193,q,1
217988,35,4,3,12,15,m,Ian.jpg,pieFS4.bmp,Ian takes valuables from his friends' homes when asked to house-sit.,1,reputation,499970,500894,924,p,0
217988,36,2,6,9,15,m,Nick.jpg,pieFS2.bmp,Nick was injured in a hit-and-run accident and cannot afford his medical bills.,2,na,513072,514374,1302,q,1
217988,37,3,3,7,10,f,Jenny.jpg,pieFS3.bmp,Jenny just lost her small business after a franchise moved in next door.,2,na,526540,527434,894,q,1
217988,38,3,2,4,6,f,Beth.jpg,pieFS3.bmp,Beth cannot afford to send her son to college.,2,na,539625,540614,989,q,1
217988,39,4,4,16,20,m,Ricky.jpg,pieFS4.bmp,Ricky is saving for his son's operation,2,na,552777,553735,958,q,1
217988,40,5,1,9,10,f,Jackie.jpg,pieFS5.bmp,Jackie used her mother's social security number to open a credit card account.,1,reputation,565912,567515,1603,p,0
217988,41,3,5,11,16,m,Ben.jpg,pieFS3.bmp,Ben was mugged and had his wallet stolen.,2,na,579663,580155,492,q,1
217988,42,5,1,9,10,m,Kevin.jpg,pieFS5.bmp,Kevin often goes through and steals the neighbors' mail.,1,reputation,592333,593035,702,p,0
217988,43,1,8,8,16,m,Brad.jpg,pieFS1.bmp,Brad has been unable to find a job for over a year.,2,na,605235,606335,1100,q,1
217988,44,5,2,18,20,m,Mark.jpg,pieFS5.bmp,Mark lost his house in a fire,2,na,618486,619535,1049,q,1
217988,45,1,9,9,18,m,Alan.jpg,pieFS1.bmp,Alan bullies his employees to put in extra hours at work.,1,reputation,631688,632275,587,p,0
217988,46,4,1,4,5,m,Darnell.jpg,pieFS4.bmp,Darnell just found $50 on the street,1,resources,644424,645295,871,q,1
217988,47,4,3,12,15,m,Paul.jpg,pieFS4.bmp,Paul just lost his job,2,na,657493,658555,1062,q,1
217988,48,3,5,11,16,f,Trish.jpg,pieFS3.bmp,Trish regularly fires employees to avoid promoting them.,1,reputation,670711,671335,624,p,0
217988,49,3,2,4,6,f,Marny.jpg,pieFS3.bmp,Marny is raising money to buy gifts for children in need.,2,na,683497,684315,818,q,1
217988,50,5,1,9,10,f,Kay.jpg,pieFS5.bmp,Kay secretly gambles with her husband's savings.,1,reputation,696465,698235,1770,p,0
217988,51,3,4,9,13,m,Edward.jpg,pieFS3.bmp,Edward employs illegal immigrants and pays them less than minimum wage.,1,reputation,710400,712155,1755,p,0
217988,52,3,6,14,20,m,Sam.jpg,pieFS3.bmp,Sam is homeless,2,na,724301,725315,1014,q,1
218207,1,5,1,9,10,m,Justin.jpg,pieFS5.bmp,Justin bullies his employees to put in extra hours at work.,1,reputation,45503,49724,4221,m,0
218207,2,5,1,9,10,f,Miriam.jpg,pieFS5.bmp,Miriam owns an international company,1,resources,61823,63865,2042,m,0
218207,3,3,2,4,6,f,Kelly.jpg,pieFS3.bmp,Kelly got a large cash bonus from her boss,1,resources,75968,81944,5976,z,1
218207,4,2,3,4,7,m,Michael.jpg,pieFS2.bmp,Michael lost his house in a fire,2,na,94060,96680,2620,z,1
218207,5,3,4,9,13,m,Brad.jpg,pieFS3.bmp,Brad just found $50 on the street,1,resources,108775,114227,5452,z,1
218207,6,4,2,8,10,f,Cindy.jpg,pieFS4.bmp,Cindy was a victim of identity theft and is now thousands of dollars in debt.,2,na,126332,131273,4941,z,1
218207,7,4,4,16,20,f,Mary.jpg,pieFS4.bmp,Mary received a large inheritance from a distant relative,1,resources,143370,144986,1616,m,0
218207,8,5,1,9,10,f,Janet.jpg,pieFS5.bmp,Janet is a single mother,2,na,157082,159431,2349,m,0
218207,9,4,3,12,15,f,Sharon.jpg,pieFS4.bmp,Sharon just won the lottery,1,resources,171528,174994,3466,m,0
218207,10,4,1,4,5,f,Lauren.jpg,pieFS4.bmp,Lauren works two waitressing jobs to pay her bills.,2,na,187079,189917,2838,z,1
218207,11,5,1,9,10,m,Peter.jpg,pieFS5.bmp,Peter is homeless,2,na,202011,205678,3667,z,1
218207,12,1,8,8,16,m,Saul.jpg,pieFS1.bmp,Saul is saving to pay his university fees,2,na,217795,221215,3420,z,1
218207,13,5,2,18,20,m,Edward.jpg,pieFS5.bmp,Edward just lost his job,2,na,233312,241544,8232,m,0
218207,14,3,3,7,10,f,Marny.jpg,pieFS3.bmp,Marny just received a huge cash settlement,1,resources,253645,254795,1150,m,0
218207,15,5,1,9,10,f,Deborah.jpg,pieFS5.bmp,Deborah takes discarded food from grocery stores to feed her children.,2,na,266888,272744,5856,z,1
218207,16,3,3,7,10,m,Don.jpg,pieFS3.bmp,Don lives in a luxury penthouse apartment,1,resources,284812,289219,4407,m,0
218207,17,2,3,4,7,f,Monica.jpg,pieFS2.bmp,Monica steals her coworkers' tips to buy alcohol.,1,reputation,301316,306688,5372,m,0
218207,18,4,2,8,10,f,Emma.jpg,pieFS4.bmp,Emma cannot afford to send her son to college.,2,na,318773,325676,6903,z,1
218207,19,4,4,16,20,f,Trish.jpg,pieFS4.bmp,Trish regularly fires employees to avoid promoting them.,1,reputation,337768,340174,2406,m,0
218207,20,2,7,10,17,f,Jean.jpg,pieFS2.bmp,Jean just lost her small business after a franchise moved in next door.,2,na,352265,355644,3379,z,1
218207,21,2,8,12,20,f,Emily.jpg,pieFS2.bmp,Emily used her mother's social security number to open a credit card account.,1,reputation,367731,372317,4586,z,1
218207,22,3,3,7,10,f,Eileen.jpg,pieFS3.bmp,Eileen is raising money to buy gifts for children in need.,2,na,384402,386665,2263,z,1
218207,23,3,4,9,13,m,Taymar.jpg,pieFS3.bmp,Taymar employs illegal immigrants and pays them less than minimum wage.,1,reputation,398765,402371,3606,m,0
218207,24,2,6,9,15,m,Ricky.jpg,pieFS2.bmp,Ricky could not afford his mortgage and his home was foreclosed.,2,na,414466,417013,2547,z,1
218207,25,1,9,9,18,m,Sam.jpg,pieFS1.bmp,Sam stole money from his mother's wallet.,1,reputation,429114,430857,1743,z,1
218207,26,3,5,11,16,f,Arianna.jpg,pieFS3.bmp,Arianna secretly gambles with her husband's savings.,1,reputation,442925,445875,2950,m,0
218207,27,3,5,11,16,m,Ian.jpg,pieFS3.bmp,Ian lost his life savings when his small business failed,2,na,457974,460984,3010,z,1
218207,28,2,6,9,15,m,Paul.jpg,pieFS2.bmp,Paul is hiding his taxable income in Switzerland.,1,reputation,473073,477646,4573,z,1
218207,29,5,2,18,20,m,Nick.jpg,pieFS5.bmp,Nick cheated on his taxes and is now under investigation for tax fraud.,1,reputation,489744,492897,3153,m,0
218207,30,3,6,14,20,m,Kevin.jpg,pieFS3.bmp,Kevin is a veteran having trouble finding employment.,2,na,504993,508536,3543,z,1
218207,31,4,2,8,10,m,Joe.jpg,pieFS4.bmp,Joe underreports his company's earnings and pockets the profits.,1,reputation,520627,523555,2928,m,0
218207,32,4,1,4,5,m,Daniel.jpg,pieFS4.bmp,Daniel is a well paid lawyer,1,resources,535643,539731,4088,m,0
218207,33,4,2,8,10,m,Mark.jpg,pieFS4.bmp,Mark stole his elderly father's prescription medications.,1,reputation,551829,553872,2043,m,0
218207,34,5,1,9,10,f,Sammy.jpg,pieFS5.bmp,Sammy illegally parks in the disabled parking spots when she can.,1,reputation,565958,569377,3419,m,0
218207,35,5,2,18,20,m,Tony.jpg,pieFS5.bmp,Tony declared bankruptcy after he was laid off.,2,na,581475,584796,3321,m,0
218207,36,4,3,12,15,m,Darnell.jpg,pieFS4.bmp,Darnell takes valuables from his friends' homes when asked to house-sit.,1,reputation,596891,599781,2890,m,0
218207,37,5,1,9,10,m,Ben.jpg,pieFS5.bmp,Ben was injured in a hit-and-run accident and cannot afford his medical bills.,2,na,611873,614423,2550,m,0
218207,38,4,3,12,15,f,Joanna.jpg,pieFS4.bmp,Joanna's car with her bag and credit cards was recently stolen.,2,na,626521,631475,4954,m,0
218207,39,1,10,10,20,f,Jenny.jpg,pieFS1.bmp,Jenny just found out that her husband has incurred a large credit card debt.,2,na,643559,645440,1881,z,1
218207,40,4,4,16,20,m,Jared.jpg,pieFS4.bmp,Jared is a retiree,2,na,657521,659409,1888,m,0
218207,41,3,6,14,20,m,Matt.jpg,pieFS3.bmp,Matt was mugged and had his wallet stolen.,2,na,671483,675013,3530,z,1
218207,42,5,2,18,20,f,Beth.jpg,pieFS5.bmp,Beth claims false expenses for her reportable work travel.,1,reputation,687101,689785,2684,m,0
218207,43,5,1,9,10,f,Kay.jpg,pieFS5.bmp,Kay works as a cleaner in a hotel,2,na,701882,705093,3211,m,0
218207,44,5,1,9,10,f,Louise.jpg,pieFS5.bmp,Louise's husband is a wealthy investment banker,1,resources,717181,720375,3194,m,0
218207,45,5,2,18,20,m,George.jpg,pieFS5.bmp,George just bought an expensive sports car,1,resources,732464,735439,2975,m,0
218207,46,3,4,9,13,m,Jack.jpg,pieFS3.bmp,Jack often goes through and steals the neighbors' mail.,1,reputation,747530,749652,2122,m,0
218207,47,3,2,4,6,f,Fiona.jpg,pieFS3.bmp,Fiona can't afford to pay her medical bills,2,na,761743,763752,2009,z,1
218207,48,1,5,5,10,f,Maria.jpg,pieFS1.bmp,Maria is a highly paid actress,1,resources,775838,778050,2212,z,1
218207,49,3,2,4,6,f,Jackie.jpg,pieFS3.bmp,Jackie has to take an unpaid leave of absence because her mother broke her hip.,2,na,790152,792223,2071,z,1
218207,50,4,1,4,5,m,Alan.jpg,pieFS4.bmp,Alan is saving for his son's operation,2,na,804314,807250,2936,z,1
218207,51,3,2,4,6,f,Fay.jpg,pieFS3.bmp,Fay is going to be evicted because she is behind on her rent,2,na,819346,820927,1581,z,1
218207,52,4,3,12,15,m,Stuart.jpg,pieFS4.bmp,Stuart has been unable to find a job for over a year.,2,na,833024,838038,5014,m,0
218219,1,4,2,8,10,f,Kay.jpg,pieFS4.bmp,Kay can't afford to pay her medical bills,2,na,69942,77459,7517,q,1
218219,2,3,2,4,6,f,Joanna.jpg,pieFS3.bmp,Joanna works two waitressing jobs to pay her bills.,2,na,89653,97359,7706,p,0
218219,3,5,2,18,20,f,Eileen.jpg,pieFS5.bmp,Eileen just received a huge cash settlement,1,resources,109547,110599,1052,p,0
218219,4,3,4,9,13,m,Daniel.jpg,pieFS3.bmp,Daniel is hiding his taxable income in Switzerland.,1,reputation,122799,123659,860,p,0
218219,5,2,6,9,15,m,Saul.jpg,pieFS2.bmp,Saul declared bankruptcy after he was laid off.,2,na,135834,137719,1885,q,1
218219,6,3,4,9,13,m,Stuart.jpg,pieFS3.bmp,Stuart takes valuables from his friends' homes when asked to house-sit.,1,reputation,149885,152699,2814,p,0
218219,7,3,2,4,6,f,Lauren.jpg,pieFS3.bmp,Lauren takes discarded food from grocery stores to feed her children.,2,na,164868,166959,2091,p,0
218219,8,4,2,8,10,m,George.jpg,pieFS4.bmp,George underreports his company's earnings and pockets the profits.,1,reputation,179135,180938,1803,p,0
218219,9,5,1,9,10,m,Alan.jpg,pieFS5.bmp,Alan is a well paid lawyer,1,resources,193086,194098,1012,p,0
218219,10,5,1,9,10,f,Sharon.jpg,pieFS5.bmp,Sharon is going to be evicted because she is behind on her rent,2,na,206271,207218,947,p,0
218219,11,2,3,4,7,f,Kelly.jpg,pieFS2.bmp,Kelly steals her coworkers' tips to buy alcohol.,1,reputation,219373,220258,885,p,0
218219,12,5,1,9,10,m,Jack.jpg,pieFS5.bmp,Jack was injured in a hit-and-run accident and cannot afford his medical bills.,2,na,232425,233478,1053,p,0
218219,13,4,1,4,5,m,Michael.jpg,pieFS4.bmp,Michael was mugged and had his wallet stolen.,2,na,245626,246418,792,p,0
218219,14,5,2,18,20,m,Don.jpg,pieFS5.bmp,Don often goes through and steals the neighbors' mail.,1,reputation,258595,259698,1103,p,0
218219,15,4,4,16,20,m,Brad.jpg,pieFS4.bmp,Brad has been unable to find a job for over a year.,2,na,271863,272498,635,p,0
218219,16,4,3,12,15,m,Sam.jpg,pieFS4.bmp,Sam lost his house in a fire,2,na,284665,287798,3133,q,1
218219,17,5,2,18,20,m,Mark.jpg,pieFS5.bmp,Mark just found $50 on the street,1,resources,299948,300678,730,p,0
218219,18,3,5,11,16,f,Beth.jpg,pieFS3.bmp,Beth owns an international company,1,resources,312834,315358,2524,q,1
218219,19,5,2,18,20,m,Ian.jpg,pieFS5.bmp,Ian is homeless,2,na,327517,328438,921,q,1
218219,20,3,6,14,20,m,Joe.jpg,pieFS3.bmp,Joe is a retiree,2,na,340585,342138,1553,q,1
218219,21,3,2,4,6,f,Maria.jpg,pieFS3.bmp,Maria just lost her small business after a franchise moved in next door.,2,na,354303,355738,1435,q,1
218219,22,2,3,4,7,m,Nick.jpg,pieFS2.bmp,Nick is saving to pay his university fees,2,na,367905,370058,2153,q,1
218219,23,5,1,9,10,f,Cindy.jpg,pieFS5.bmp,Cindy used her mother's social security number to open a credit card account.,1,reputation,382238,383478,1240,p,0
218219,24,4,4,16,20,f,Emma.jpg,pieFS4.bmp,Emma received a large inheritance from a distant relative,1,resources,395673,397998,2325,p,0
218219,25,3,3,7,10,m,Ben.jpg,pieFS3.bmp,Ben lives in a luxury penthouse apartment,1,resources,410190,412138,1948,p,0
218219,26,5,1,9,10,f,Arianna.jpg,pieFS5.bmp,Arianna is a single mother,2,na,424324,427558,3234,q,1
218219,27,2,7,10,17,f,Jackie.jpg,pieFS2.bmp,Jackie is raising money to buy gifts for children in need.,2,na,439723,440737,1014,q,1
218219,28,4,1,4,5,m,Peter.jpg,pieFS4.bmp,Peter stole money from his mother's wallet.,1,reputation,452925,453617,692,p,0
218219,29,5,1,9,10,m,Matt.jpg,pieFS5.bmp,Matt lost his life savings when his small business failed,2,na,465810,467437,1627,p,0
218219,30,3,3,7,10,f,Deborah.jpg,pieFS3.bmp,Deborah illegally parks in the disabled parking spots when she can.,1,reputation,479628,482257,2629,p,0
218219,31,1,9,9,18,m,Tony.jpg,pieFS1.bmp,Tony cheated on his taxes and is now under investigation for tax fraud.,1,reputation,494445,496957,2512,q,1
218219,32,4,2,8,10,m,Taymar.jpg,pieFS4.bmp,Taymar just bought an expensive sports car,1,resources,509145,510597,1452,p,0
218219,33,5,1,9,10,f,Sammy.jpg,pieFS5.bmp,Sammy's car with her bag and credit cards was recently stolen.,2,na,522796,524017,1221,p,0
218219,34,3,6,14,20,m,Ricky.jpg,pieFS3.bmp,Ricky is saving for his son's operation,2,na,536214,536897,683,q,1
218219,35,2,8,12,20,f,Mary.jpg,pieFS2.bmp,Mary just won the lottery,1,resources,549099,550617,1518,p,0
218219,36,2,6,9,15,m,Edward.jpg,pieFS2.bmp,Edward bullies his employees to put in extra hours at work.,1,reputation,562817,564957,2140,q,1
218219,37,4,3,12,15,f,Janet.jpg,pieFS4.bmp,Janet cannot afford to send her son to college.,2,na,577151,579777,2626,q,1
218219,38,1,10,10,20,f,Jenny.jpg,pieFS1.bmp,Jenny just found out that her husband has incurred a large credit card debt.,2,na,591967,594097,2130,q,1
218219,39,1,5,5,10,f,Fiona.jpg,pieFS1.bmp,Fiona regularly fires employees to avoid promoting them.,1,reputation,606301,609377,3076,q,1
218219,40,4,3,12,15,f,Miriam.jpg,pieFS4.bmp,Miriam secretly gambles with her husband's savings.,1,reputation,621567,622597,1030,p,0
218219,41,5,1,9,10,f,Louise.jpg,pieFS5.bmp,Louise claims false expenses for her reportable work travel.,1,reputation,634786,636516,1730,q,1
218219,42,5,1,9,10,f,Jean.jpg,pieFS5.bmp,Jean is a highly paid actress,1,resources,648720,649616,896,p,0
218219,43,3,5,11,16,m,Darnell.jpg,pieFS3.bmp,Darnell is a veteran having trouble finding employment.,2,na,661805,664336,2531,q,1
218219,44,1,8,8,16,m,Jared.jpg,pieFS1.bmp,Jared just lost his job,2,na,676538,678436,1898,q,1
218219,45,4,2,8,10,f,Marny.jpg,pieFS4.bmp,Marny has to take an unpaid leave of absence because her mother broke her hip.,2,na,690639,695076,4437,p,0
218219,46,3,3,7,10,f,Fay.jpg,pieFS3.bmp,Fay works as a cleaner in a hotel,2,na,707270,709496,2226,q,1
218219,47,4,4,16,20,f,Trish.jpg,pieFS4.bmp,Trish's husband is a wealthy investment banker,1,resources,721687,723316,1629,p,0
218219,48,3,2,4,6,f,Monica.jpg,pieFS3.bmp,Monica got a large cash bonus from her boss,1,resources,735505,737456,1951,q,1
218219,49,4,3,12,15,m,Paul.jpg,pieFS4.bmp,Paul employs illegal immigrants and pays them less than minimum wage.,1,reputation,749656,751256,1600,p,0
218219,50,3,4,9,13,m,Kevin.jpg,pieFS3.bmp,Kevin stole his elderly father's prescription medications.,1,reputation,763457,764336,879,p,0
218219,51,5,2,18,20,m,Justin.jpg,pieFS5.bmp,Justin could not afford his mortgage and his home was foreclosed.,2,na,776525,777936,1411,p,0
218219,52,4,1,4,5,f,Emily.jpg,pieFS4.bmp,Emily was a victim of identity theft and is now thousands of dollars in debt.,2,na,790126,791576,1450,p,0
218457,1,5,1,9,10,m,Daniel.jpg,pieFS5.bmp,Daniel employs illegal immigrants and pays them less than minimum wage.,1,reputation,57847,62258,4411,p,0
218457,2,5,2,18,20,m,Nick.jpg,pieFS5.bmp,Nick is a veteran having trouble finding employment.,2,na,74445,78418,3973,p,0
218457,3,3,2,4,6,f,Miriam.jpg,pieFS3.bmp,Miriam works as a cleaner in a hotel,2,na,90594,100559,9965,p,0
218457,4,4,2,8,10,f,Maria.jpg,pieFS4.bmp,Maria works two waitressing jobs to pay her bills.,2,na,112736,115719,2983,p,0
218457,5,4,4,16,20,f,Trish.jpg,pieFS4.bmp,Trish's husband is a wealthy investment banker,1,resources,127903,134000,6097,q,1
218457,6,4,1,4,5,m,Matt.jpg,pieFS4.bmp,Matt stole his elderly father's prescription medications.,1,reputation,146183,148680,2497,p,0
218457,7,3,3,7,10,f,Emily.jpg,pieFS3.bmp,Emily just received a huge cash settlement,1,resources,160867,162840,1973,p,0
218457,8,4,4,16,20,m,Michael.jpg,pieFS4.bmp,Michael declared bankruptcy after he was laid off.,2,na,175018,179061,4043,p,0
218457,9,4,2,8,10,f,Joanna.jpg,pieFS4.bmp,Joanna takes discarded food from grocery stores to feed her children.,2,na,191233,197601,6368,p,0
218457,10,1,5,5,10,f,Sammy.jpg,pieFS1.bmp,Sammy steals her coworkers' tips to buy alcohol.,1,reputation,209779,214562,4783,q,1
218457,11,5,1,9,10,f,Marny.jpg,pieFS5.bmp,Marny just lost her small business after a franchise moved in next door.,2,na,226744,230162,3418,p,0
218457,12,5,1,9,10,f,Jenny.jpg,pieFS5.bmp,Jenny used her mother's social security number to open a credit card account.,1,reputation,242343,244362,2019,p,0
218457,13,5,1,9,10,f,Deborah.jpg,pieFS5.bmp,Deborah is raising money to buy gifts for children in need.,2,na,256544,258403,1859,p,0
218457,14,1,10,10,20,f,Louise.jpg,pieFS1.bmp,Louise can't afford to pay her medical bills,2,na,270579,272763,2184,q,1
218457,15,3,4,9,13,m,Saul.jpg,pieFS3.bmp,Saul takes valuables from his friends' homes when asked to house-sit.,1,reputation,284946,287804,2858,p,0
218457,16,3,6,14,20,m,Joe.jpg,pieFS3.bmp,Joe could not afford his mortgage and his home was foreclosed.,2,na,299980,301664,1684,p,0
218457,17,4,2,8,10,m,Edward.jpg,pieFS4.bmp,Edward is hiding his taxable income in Switzerland.,1,reputation,313831,315944,2113,p,0
218457,18,4,2,8,10,m,Alan.jpg,pieFS4.bmp,Alan underreports his company's earnings and pockets the profits.,1,reputation,328116,329885,1769,p,0
218457,19,5,1,9,10,f,Janet.jpg,pieFS5.bmp,Janet is going to be evicted because she is behind on her rent,2,na,342050,343545,1495,p,0
218457,20,5,1,9,10,m,Jack.jpg,pieFS5.bmp,Jack was injured in a hit-and-run accident and cannot afford his medical bills.,2,na,355718,357105,1387,p,0
218457,21,2,3,4,7,f,Jean.jpg,pieFS2.bmp,Jean illegally parks in the disabled parking spots when she can.,1,reputation,369270,373646,4376,q,1
218457,22,2,8,12,20,f,Fiona.jpg,pieFS2.bmp,Fiona owns an international company,1,resources,385802,390866,5064,q,1
218457,23,5,1,9,10,f,Beth.jpg,pieFS5.bmp,Beth received a large inheritance from a distant relative,1,resources,403016,404327,1311,p,0
218457,24,1,9,9,18,m,Jared.jpg,pieFS1.bmp,Jared is a well paid lawyer,1,resources,416485,419067,2582,q,1
218457,25,3,6,14,20,m,Brad.jpg,pieFS3.bmp,Brad was mugged and had his wallet stolen.,2,na,431219,433427,2208,p,0
218457,26,3,3,7,10,m,Don.jpg,pieFS3.bmp,Don often goes through and steals the neighbors' mail.,1,reputation,445586,447528,1942,p,0
218457,27,3,3,7,10,f,Arianna.jpg,pieFS3.bmp,Arianna is a single mother,2,na,459687,462468,2781,p,0
218457,28,2,7,10,17,f,Cindy.jpg,pieFS2.bmp,Cindy's car with her bag and credit cards was recently stolen.,2,na,474637,476589,1952,p,0
218457,29,4,3,12,15,m,Justin.jpg,pieFS4.bmp,Justin is a retiree,2,na,488739,490789,2050,p,0
218457,30,4,1,4,5,f,Lauren.jpg,pieFS4.bmp,Lauren just found out that her husband has incurred a large credit card debt.,2,na,502956,505249,2293,p,0
218457,31,1,8,8,16,m,Stuart.jpg,pieFS1.bmp,Stuart has been unable to find a job for over a year.,2,na,517407,519490,2083,q,1
218457,32,3,2,4,6,f,Emma.jpg,pieFS3.bmp,Emma just won the lottery,1,resources,531641,536290,4649,p,0
218457,33,3,2,4,6,f,Mary.jpg,pieFS3.bmp,Mary cannot afford to send her son to college.,2,na,548439,551830,3391,p,0
218457,34,3,5,11,16,f,Jackie.jpg,pieFS3.bmp,Jackie is a highly paid actress,1,resources,563989,566751,2762,p,0
218457,35,5,2,18,20,m,George.jpg,pieFS5.bmp,George just bought an expensive sports car,1,resources,578906,581151,2245,p,0
218457,36,5,2,18,20,f,Kay.jpg,pieFS5.bmp,Kay regularly fires employees to avoid promoting them.,1,reputation,593307,595292,1985,p,0
218457,37,4,4,16,20,f,Fay.jpg,pieFS4.bmp,Fay secretly gambles with her husband's savings.,1,reputation,607441,609992,2551,p,0
218457,38,5,1,9,10,f,Sharon.jpg,pieFS5.bmp,Sharon claims false expenses for her reportable work travel.,1,reputation,622142,624412,2270,p,0
218457,39,2,6,9,15,m,Kevin.jpg,pieFS2.bmp,Kevin lost his house in a fire,2,na,636559,639013,2454,p,0
218457,40,4,3,12,15,f,Eileen.jpg,pieFS4.bmp,Eileen has to take an unpaid leave of absence because her mother broke her hip.,2,na,651193,653653,2460,p,0
218457,41,3,4,9,13,m,Peter.jpg,pieFS3.bmp,Peter just found $50 on the street,1,resources,665810,670234,4424,p,0
218457,42,4,3,12,15,f,Kelly.jpg,pieFS4.bmp,Kelly got a large cash bonus from her boss,1,resources,682392,684954,2562,p,0
218457,43,4,1,4,5,m,Tony.jpg,pieFS4.bmp,Tony is homeless,2,na,697109,709295,12186,p,0
218457,44,2,3,4,7,m,Ian.jpg,pieFS2.bmp,Ian is saving to pay his university fees,2,na,721465,724635,3170,q,1
218457,45,3,2,4,6,f,Monica.jpg,pieFS3.bmp,Monica was a victim of identity theft and is now thousands of dollars in debt.,2,na,736815,740295,3480,p,0
218457,46,3,4,9,13,m,Sam.jpg,pieFS3.bmp,Sam lives in a luxury penthouse apartment,1,resources,752448,755256,2808,p,0
218457,47,5,2,18,20,m,Ben.jpg,pieFS5.bmp,Ben stole money from his mother's wallet.,1,reputation,767415,770236,2821,p,0
218457,48,3,5,11,16,m,Mark.jpg,pieFS3.bmp,Mark lost his life savings when his small business failed,2,na,782398,785397,2999,p,0
218457,49,4,3,12,15,m,Darnell.jpg,pieFS4.bmp,Darnell cheated on his taxes and is now under investigation for tax fraud.,1,reputation,797565,799997,2432,p,0
218457,50,5,2,18,20,m,Ricky.jpg,pieFS5.bmp,Ricky is saving for his son's operation,2,na,812149,814397,2248,p,0
218457,51,2,6,9,15,m,Taymar.jpg,pieFS2.bmp,Taymar bullies his employees to put in extra hours at work.,1,reputation,826566,829938,3372,p,0
218457,52,5,1,9,10,m,Paul.jpg,pieFS5.bmp,Paul just lost his job,2,na,842099,845218,3119,p,0
218572,1,5,1,9,10,m,Jared.jpg,pieFS5.bmp,Jared is a retiree,2,na,39534,42444,2910,p,0
218572,2,1,5,5,10,f,Maria.jpg,pieFS1.bmp,Maria steals her coworkers' tips to buy alcohol.,1,reputation,54617,67684,13067,p,0
218572,3,3,2,4,6,f,Marny.jpg,pieFS3.bmp,Marny just lost her small business after a franchise moved in next door.,2,na,79856,87545,7689,q,1
218572,4,1,9,9,18,m,Taymar.jpg,pieFS1.bmp,Taymar just bought an expensive sports car,1,resources,99717,106685,6968,q,1
218572,5,3,5,11,16,f,Sammy.jpg,pieFS3.bmp,Sammy used her mother's social security number to open a credit card account.,1,reputation,118879,121086,2207,p,0
218572,6,4,3,12,15,f,Kay.jpg,pieFS4.bmp,Kay just won the lottery,1,resources,133247,136106,2859,p,0
218572,7,2,7,10,17,f,Kelly.jpg,pieFS2.bmp,Kelly is raising money to buy gifts for children in need.,2,na,148280,150327,2047,q,1
218572,8,3,3,7,10,f,Fiona.jpg,pieFS3.bmp,Fiona cannot afford to send her son to college.,2,na,162515,166207,3692,q,1
218572,9,3,3,7,10,f,Emma.jpg,pieFS3.bmp,Emma regularly fires employees to avoid promoting them.,1,reputation,178397,180207,1810,p,0
218572,10,4,3,12,15,m,Jack.jpg,pieFS4.bmp,Jack takes valuables from his friends' homes when asked to house-sit.,1,reputation,192382,195248,2866,p,0
218572,11,3,6,14,20,m,Justin.jpg,pieFS3.bmp,Justin is saving for his son's operation,2,na,207415,208988,1573,q,1
218572,12,4,4,16,20,f,Joanna.jpg,pieFS4.bmp,Joanna illegally parks in the disabled parking spots when she can.,1,reputation,221183,223249,2066,p,0
218572,13,4,4,16,20,f,Janet.jpg,pieFS4.bmp,Janet secretly gambles with her husband's savings.,1,reputation,235434,237189,1755,p,0
218572,14,4,3,12,15,f,Deborah.jpg,pieFS4.bmp,Deborah's car with her bag and credit cards was recently stolen.,2,na,249386,251389,2003,q,1
218572,15,4,4,16,20,m,Don.jpg,pieFS4.bmp,Don was injured in a hit-and-run accident and cannot afford his medical bills.,2,na,263587,265189,1602,q,1
218572,16,4,2,8,10,f,Jackie.jpg,pieFS4.bmp,Jackie just found out that her husband has incurred a large credit card debt.,2,na,277388,280190,2802,p,0
218572,17,5,1,9,10,f,Eileen.jpg,pieFS5.bmp,Eileen is a highly paid actress,1,resources,292388,294070,1682,p,0
218572,18,4,3,12,15,m,Peter.jpg,pieFS4.bmp,Peter was mugged and had his wallet stolen.,2,na,306256,307871,1615,q,1
218572,19,5,1,9,10,m,Sam.jpg,pieFS5.bmp,Sam often goes through and steals the neighbors' mail.,1,reputation,320058,321531,1473,p,0
218572,20,5,1,9,10,f,Emily.jpg,pieFS5.bmp,Emily has to take an unpaid leave of absence because her mother broke her hip.,2,na,333726,335331,1605,q,1
218572,21,3,5,11,16,m,Michael.jpg,pieFS3.bmp,Michael has been unable to find a job for over a year.,2,na,347527,349132,1605,q,1
218572,22,3,2,4,6,f,Beth.jpg,pieFS3.bmp,Beth claims false expenses for her reportable work travel.,1,reputation,361329,362792,1463,p,0
218572,23,5,2,18,20,m,Mark.jpg,pieFS5.bmp,Mark lost his house in a fire,2,na,374980,376472,1492,q,1
218572,24,4,2,8,10,m,Matt.jpg,pieFS4.bmp,Matt just found $50 on the street,1,resources,388665,392213,3548,p,0
218572,25,2,6,9,15,m,Darnell.jpg,pieFS2.bmp,Darnell is homeless,2,na,404415,405953,1538,q,1
218572,26,2,6,9,15,m,Alan.jpg,pieFS2.bmp,Alan bullies his employees to put in extra hours at work.,1,reputation,418150,421014,2864,p,0
218572,27,5,1,9,10,f,Mary.jpg,pieFS5.bmp,Mary works as a cleaner in a hotel,2,na,433216,435234,2018,p,0
218572,28,5,1,9,10,f,Jean.jpg,pieFS5.bmp,Jean got a large cash bonus from her boss,1,resources,447434,449714,2280,p,0
218572,29,1,8,8,16,m,Nick.jpg,pieFS1.bmp,Nick is saving to pay his university fees,2,na,461918,463735,1817,q,1
218572,30,4,1,4,5,f,Cindy.jpg,pieFS4.bmp,Cindy was a victim of identity theft and is now thousands of dollars in debt.,2,na,475936,477475,1539,q,1
218572,31,5,2,18,20,m,Saul.jpg,pieFS5.bmp,Saul lives in a luxury penthouse apartment,1,resources,489671,491176,1505,p,0
218572,32,5,1,9,10,m,Edward.jpg,pieFS5.bmp,Edward just lost his job,2,na,503372,505496,2124,q,1
218572,33,3,4,9,13,m,Kevin.jpg,pieFS3.bmp,Kevin stole money from his mother's wallet.,1,reputation,517690,519396,1706,p,0
218572,34,5,2,18,20,m,Tony.jpg,pieFS5.bmp,Tony lost his life savings when his small business failed,2,na,531591,533596,2005,q,1
218572,35,4,1,4,5,m,Ben.jpg,pieFS4.bmp,Ben cheated on his taxes and is now under investigation for tax fraud.,1,reputation,545792,547457,1665,p,0
218572,36,3,4,9,13,m,Daniel.jpg,pieFS3.bmp,Daniel employs illegal immigrants and pays them less than minimum wage.,1,reputation,559644,561257,1613,p,0
218572,37,2,3,4,7,f,Miriam.jpg,pieFS2.bmp,Miriam's husband is a wealthy investment banker,1,resources,573445,577938,4493,q,1
218572,38,3,6,14,20,m,Paul.jpg,pieFS3.bmp,Paul could not afford his mortgage and his home was foreclosed.,2,na,590127,591698,1571,q,1
218572,39,5,1,9,10,f,Arianna.jpg,pieFS5.bmp,Arianna can't afford to pay her medical bills,2,na,603895,607078,3183,q,1
218572,40,3,2,4,6,f,Trish.jpg,pieFS3.bmp,Trish is going to be evicted because she is behind on her rent,2,na,619261,620639,1378,q,1
218572,41,5,2,18,20,f,Louise.jpg,pieFS5.bmp,Louise owns an international company,1,resources,632830,634299,1469,p,0
218572,42,1,10,10,20,f,Lauren.jpg,pieFS1.bmp,Lauren works two waitressing jobs to pay her bills.,2,na,646498,648039,1541,q,1
218572,43,5,1,9,10,f,Fay.jpg,pieFS5.bmp,Fay received a large inheritance from a distant relative,1,resources,660216,662960,2744,q,1
218572,44,3,3,7,10,m,George.jpg,pieFS3.bmp,George is hiding his taxable income in Switzerland.,1,reputation,675133,676600,1467,p,0
218572,45,3,4,9,13,m,Ricky.jpg,pieFS3.bmp,Ricky underreports his company's earnings and pockets the profits.,1,reputation,688768,690081,1313,p,0
218572,46,2,8,12,20,f,Jenny.jpg,pieFS2.bmp,Jenny just received a huge cash settlement,1,resources,702270,712001,9731,p,0
218572,47,4,1,4,5,m,Ian.jpg,pieFS4.bmp,Ian is a veteran having trouble finding employment.,2,na,724179,725682,1503,q,1
218572,48,5,2,18,20,m,Joe.jpg,pieFS5.bmp,Joe is a well paid lawyer,1,resources,737864,739462,1598,p,0
218572,49,4,2,8,10,m,Stuart.jpg,pieFS4.bmp,Stuart stole his elderly father's prescription medications.,1,reputation,751632,753902,2270,p,0
218572,50,3,2,4,6,f,Monica.jpg,pieFS3.bmp,Monica takes discarded food from grocery stores to feed her children.,2,na,766066,767643,1577,q,1
218572,51,2,3,4,7,m,Brad.jpg,pieFS2.bmp,Brad declared bankruptcy after he was laid off.,2,na,779801,781403,1602,q,1
218572,52,4,2,8,10,f,Sharon.jpg,pieFS4.bmp,Sharon is a single mother,2,na,793553,795143,1590,q,1
218714,1,2,8,12,20,f,Eileen.jpg,pieFS2.bmp,Eileen used her mother's social security number to open a credit card account.,1,reputation,56388,58197,1809,q,1
218714,2,3,3,7,10,m,Ben.jpg,pieFS3.bmp,Ben stole his elderly father's prescription medications.,1,reputation,70373,72697,2324,q,1
218714,3,5,1,9,10,f,Kelly.jpg,pieFS5.bmp,Kelly is raising money to buy gifts for children in need.,2,na,84890,85717,827,q,1
218714,4,3,2,4,6,f,Beth.jpg,pieFS3.bmp,Beth received a large inheritance from a distant relative,1,resources,97909,99517,1608,q,1
218714,5,5,1,9,10,f,Fiona.jpg,pieFS5.bmp,Fiona is a single mother,2,na,111710,113538,1828,q,1
218714,6,4,4,16,20,m,Daniel.jpg,pieFS4.bmp,Daniel is saving for his son's operation,2,na,125728,126938,1210,q,1
218714,7,5,1,9,10,m,Saul.jpg,pieFS5.bmp,Saul declared bankruptcy after he was laid off.,2,na,139130,140338,1208,q,1
218714,8,3,4,9,13,m,Jack.jpg,pieFS3.bmp,Jack takes valuables from his friends' homes when asked to house-sit.,1,reputation,152532,154338,1806,q,1
218714,9,3,6,14,20,m,Ian.jpg,pieFS3.bmp,Ian was injured in a hit-and-run accident and cannot afford his medical bills.,2,na,166533,168559,2026,q,1
218714,10,5,1,9,10,f,Maria.jpg,pieFS5.bmp,Maria illegally parks in the disabled parking spots when she can.,1,reputation,180750,182179,1429,q,1
218714,11,3,2,4,6,f,Joanna.jpg,pieFS3.bmp,Joanna's car with her bag and credit cards was recently stolen.,2,na,194369,196199,1830,q,1
218714,12,3,2,4,6,f,Emily.jpg,pieFS3.bmp,Emily just found out that her husband has incurred a large credit card debt.,2,na,208386,209699,1313,q,1
218714,13,5,1,9,10,m,Joe.jpg,pieFS5.bmp,Joe bullies his employees to put in extra hours at work.,1,reputation,221871,224780,2909,p,0
218714,14,4,3,12,15,m,Paul.jpg,pieFS4.bmp,Paul just lost his job,2,na,236971,238520,1549,q,1
218714,15,2,3,4,7,m,Tony.jpg,pieFS2.bmp,Tony was mugged and had his wallet stolen.,2,na,250723,253100,2377,q,1
218714,16,4,3,12,15,f,Arianna.jpg,pieFS4.bmp,Arianna just won the lottery,1,resources,265290,268040,2750,q,1
218714,17,3,5,11,16,f,Marny.jpg,pieFS3.bmp,Marny is a highly paid actress,1,resources,280223,281801,1578,q,1
218714,18,4,3,12,15,m,Edward.jpg,pieFS4.bmp,Edward employs illegal immigrants and pays them less than minimum wage.,1,reputation,293991,296581,2590,q,1
218714,19,4,2,8,10,f,Fay.jpg,pieFS4.bmp,Fay cannot afford to send her son to college.,2,na,308775,309901,1126,q,1
218714,20,4,2,8,10,m,Darnell.jpg,pieFS4.bmp,Darnell often goes through and steals the neighbors' mail.,1,reputation,322093,324301,2208,q,1
218714,21,4,3,12,15,f,Lauren.jpg,pieFS4.bmp,Lauren has to take an unpaid leave of absence because her mother broke her hip.,2,na,336494,337302,808,q,1
218714,22,3,6,14,20,m,Matt.jpg,pieFS3.bmp,Matt has been unable to find a job for over a year.,2,na,349496,350782,1286,q,1
218714,23,1,8,8,16,m,George.jpg,pieFS1.bmp,George could not afford his mortgage and his home was foreclosed.,2,na,362965,365322,2357,q,1
218714,24,5,1,9,10,m,Michael.jpg,pieFS5.bmp,Michael lost his house in a fire,2,na,377499,379602,2103,q,1
218714,25,5,2,18,20,m,Peter.jpg,pieFS5.bmp,Peter just found $50 on the street,1,resources,391799,394343,2544,q,1
218714,26,5,1,9,10,f,Cindy.jpg,pieFS5.bmp,Cindy got a large cash bonus from her boss,1,resources,406533,409223,2690,q,1
218714,27,5,2,18,20,f,Kay.jpg,pieFS5.bmp,Kay regularly fires employees to avoid promoting them.,1,reputation,421417,424703,3286,q,1
218714,28,4,1,4,5,m,Sam.jpg,pieFS4.bmp,Sam is homeless,2,na,436899,437823,924,q,1
218714,29,4,4,16,20,f,Miriam.jpg,pieFS4.bmp,Miriam secretly gambles with her husband's savings.,1,reputation,450018,452004,1986,q,1
218714,30,4,2,8,10,m,Ricky.jpg,pieFS4.bmp,Ricky is hiding his taxable income in Switzerland.,1,reputation,464202,466324,2122,q,1
218714,31,2,7,10,17,f,Deborah.jpg,pieFS2.bmp,Deborah was a victim of identity theft and is now thousands of dollars in debt.,2,na,478520,479704,1184,q,1
218714,32,1,10,10,20,f,Jenny.jpg,pieFS1.bmp,Jenny works two waitressing jobs to pay her bills.,2,na,491888,493164,1276,q,1
218714,33,2,6,9,15,m,Nick.jpg,pieFS2.bmp,Nick is saving to pay his university fees,2,na,505357,508345,2988,q,1
218714,34,4,1,4,5,m,Mark.jpg,pieFS4.bmp,Mark lives in a luxury penthouse apartment,1,resources,520540,522085,1545,q,1
218714,35,3,4,9,13,m,Kevin.jpg,pieFS3.bmp,Kevin stole money from his mother's wallet.,1,reputation,534275,536045,1770,q,1
218714,36,4,4,16,20,f,Monica.jpg,pieFS4.bmp,Monica just received a huge cash settlement,1,resources,548242,549365,1123,q,1
218714,37,3,5,11,16,m,Stuart.jpg,pieFS3.bmp,Stuart lost his life savings when his small business failed,2,na,561561,563206,1645,q,1
218714,38,3,2,4,6,f,Jackie.jpg,pieFS3.bmp,Jackie takes discarded food from grocery stores to feed her children.,2,na,575396,576466,1070,q,1
218714,39,1,5,5,10,f,Jean.jpg,pieFS1.bmp,Jean steals her coworkers' tips to buy alcohol.,1,reputation,588614,590206,1592,q,1
218714,40,5,2,18,20,m,Taymar.jpg,pieFS5.bmp,Taymar underreports his company's earnings and pockets the profits.,1,reputation,602382,606266,3884,q,1
218714,41,3,3,7,10,f,Emma.jpg,pieFS3.bmp,Emma claims false expenses for her reportable work travel.,1,reputation,618415,619747,1332,q,1
218714,42,1,9,9,18,m,Alan.jpg,pieFS1.bmp,Alan is a well paid lawyer,1,resources,631900,634527,2627,q,1
218714,43,3,4,9,13,m,Brad.jpg,pieFS3.bmp,Brad cheated on his taxes and is now under investigation for tax fraud.,1,reputation,646683,648367,1684,q,1
218714,44,4,1,4,5,f,Louise.jpg,pieFS4.bmp,Louise works as a cleaner in a hotel,2,na,660518,662047,1529,q,1
218714,45,5,1,9,10,f,Sammy.jpg,pieFS5.bmp,Sammy just lost her small business after a franchise moved in next door.,2,na,674203,675128,925,q,1
218714,46,2,3,4,7,f,Trish.jpg,pieFS2.bmp,Trish's husband is a wealthy investment banker,1,resources,687288,689308,2020,q,1
218714,47,5,2,18,20,m,Justin.jpg,pieFS5.bmp,Justin is a retiree,2,na,701456,702308,852,q,1
218714,48,5,2,18,20,m,Don.jpg,pieFS5.bmp,Don is a veteran having trouble finding employment.,2,na,714475,715708,1233,q,1
218714,49,2,6,9,15,m,Jared.jpg,pieFS2.bmp,Jared just bought an expensive sports car,1,resources,727860,729449,1589,q,1
218714,50,3,3,7,10,f,Janet.jpg,pieFS3.bmp,Janet can't afford to pay her medical bills,2,na,741595,743149,1554,q,1
218714,51,4,2,8,10,f,Mary.jpg,pieFS4.bmp,Mary is going to be evicted because she is behind on her rent,2,na,755296,756209,913,q,1
218714,52,5,1,9,10,f,Sharon.jpg,pieFS5.bmp,Sharon owns an international company,1,resources,768381,770129,1748,q,1
219052,1,5,2,18,20,f,Kay.jpg,pieFS5.bmp,Kay just won the lottery,1,resources,65384,75059,9675,q,1
219052,2,2,3,4,7,m,Taymar.jpg,pieFS2.bmp,Taymar is a retiree,2,na,87260,94259,6999,p,0
219052,3,4,3,12,15,m,Michael.jpg,pieFS4.bmp,Michael takes valuables from his friends' homes when asked to house-sit.,1,reputation,106455,114919,8464,q,1
219052,4,1,10,10,20,f,Miriam.jpg,pieFS1.bmp,Miriam cannot afford to send her son to college.,2,na,127115,152062,24947,q,1
219052,5,4,4,16,20,f,Marny.jpg,pieFS4.bmp,Marny illegally parks in the disabled parking spots when she can.,1,reputation,164257,173819,9562,q,1
219052,6,5,2,18,20,m,Peter.jpg,pieFS5.bmp,Peter was injured in a hit-and-run accident and cannot afford his medical bills.,2,na,185999,191699,5700,q,1
219052,7,3,2,4,6,f,Jackie.jpg,pieFS3.bmp,Jackie's car with her bag and credit cards was recently stolen.,2,na,203895,206879,2984,q,1
219052,8,5,1,9,10,f,Sammy.jpg,pieFS5.bmp,Sammy just found out that her husband has incurred a large credit card debt.,2,na,219078,227619,8541,q,1
219052,9,5,1,9,10,f,Maria.jpg,pieFS5.bmp,Maria is a highly paid actress,1,resources,239822,243319,3497,q,1
219052,10,5,1,9,10,f,Louise.jpg,pieFS5.bmp,Louise regularly fires employees to avoid promoting them.,1,reputation,255521,259279,3758,p,0
219052,11,5,2,18,20,m,Darnell.jpg,pieFS5.bmp,Darnell was mugged and had his wallet stolen.,2,na,271469,274339,2870,q,1
219052,12,5,1,9,10,f,Kelly.jpg,pieFS5.bmp,Kelly has to take an unpaid leave of absence because her mother broke her hip.,2,na,286536,289599,3063,q,1
219052,13,5,2,18,20,m,George.jpg,pieFS5.bmp,George just bought an expensive sports car,1,resources,301802,305459,3657,q,1
219052,14,3,3,7,10,f,Lauren.jpg,pieFS3.bmp,Lauren got a large cash bonus from her boss,1,resources,317634,323979,6345,p,0
219052,15,5,1,9,10,m,Ben.jpg,pieFS5.bmp,Ben often goes through and steals the neighbors' mail.,1,reputation,336180,339279,3099,p,0
219052,16,4,3,12,15,f,Sharon.jpg,pieFS4.bmp,Sharon secretly gambles with her husband's savings.,1,reputation,351463,353959,2496,p,0
219052,17,1,5,5,10,f,Janet.jpg,pieFS1.bmp,Janet claims false expenses for her reportable work travel.,1,reputation,366130,368759,2629,p,0
219052,18,5,1,9,10,m,Don.jpg,pieFS5.bmp,Don has been unable to find a job for over a year.,2,na,380930,390699,9769,p,0
219052,19,4,1,4,5,m,Sam.jpg,pieFS4.bmp,Sam lost his house in a fire,2,na,402888,406279,3391,q,1
219052,20,2,6,9,15,m,Joe.jpg,pieFS2.bmp,Joe is saving for his son's operation,2,na,418471,424060,5589,q,1
219052,21,2,6,9,15,m,Paul.jpg,pieFS2.bmp,Paul bullies his employees to put in extra hours at work.,1,reputation,436234,438340,2106,p,0
219052,22,3,4,9,13,m,Nick.jpg,pieFS3.bmp,Nick just found $50 on the street,1,resources,450518,454320,3802,q,1
219052,23,3,3,7,10,f,Cindy.jpg,pieFS3.bmp,Cindy was a victim of identity theft and is now thousands of dollars in debt.,2,na,466500,469960,3460,q,1
219052,24,3,6,14,20,m,Ricky.jpg,pieFS3.bmp,Ricky just lost his job,2,na,482116,483460,1344,q,1
219052,25,3,6,14,20,m,Tony.jpg,pieFS3.bmp,Tony is homeless,2,na,495617,497180,1563,q,1
219052,26,5,1,9,10,f,Trish.jpg,pieFS5.bmp,Trish works as a cleaner in a hotel,2,na,509335,511160,1825,q,1
219052,27,3,2,4,6,f,Mary.jpg,pieFS3.bmp,Mary's husband is a wealthy investment banker,1,resources,523320,528320,5000,p,0
219052,28,4,3,12,15,m,Brad.jpg,pieFS4.bmp,Brad is saving to pay his university fees,2,na,540467,544260,3793,q,1
219052,29,4,1,4,5,m,Matt.jpg,pieFS4.bmp,Matt lives in a luxury penthouse apartment,1,resources,556416,560000,3584,q,1
219052,30,3,3,7,10,m,Mark.jpg,pieFS3.bmp,Mark stole money from his mother's wallet.,1,reputation,572165,573440,1275,p,0
219052,31,4,1,4,5,f,Emma.jpg,pieFS4.bmp,Emma can't afford to pay her medical bills,2,na,585600,588000,2400,q,1
219052,32,5,1,9,10,m,Stuart.jpg,pieFS5.bmp,Stuart lost his life savings when his small business failed,2,na,600166,602380,2214,q,1
219052,33,2,7,10,17,f,Fiona.jpg,pieFS2.bmp,Fiona is going to be evicted because she is behind on her rent,2,na,614550,618360,3810,q,1
219052,34,4,2,8,10,m,Ian.jpg,pieFS4.bmp,Ian cheated on his taxes and is now under investigation for tax fraud.,1,reputation,630532,631780,1248,p,0
219052,35,5,1,9,10,f,Arianna.jpg,pieFS5.bmp,Arianna owns an international company,1,resources,643951,646520,2569,q,1
219052,36,4,3,12,15,f,Eileen.jpg,pieFS4.bmp,Eileen works two waitressing jobs to pay her bills.,2,na,658684,661360,2676,q,1
219052,37,2,8,12,20,f,Jenny.jpg,pieFS2.bmp,Jenny just received a huge cash settlement,1,resources,673517,675040,1523,q,1
219052,38,4,4,16,20,m,Kevin.jpg,pieFS4.bmp,Kevin is a veteran having trouble finding employment.,2,na,687202,689680,2478,q,1
219052,39,4,2,8,10,m,Jack.jpg,pieFS4.bmp,Jack stole his elderly father's prescription medications.,1,reputation,701835,703140,1305,p,0
219052,40,3,2,4,6,f,Jean.jpg,pieFS3.bmp,Jean takes discarded food from grocery stores to feed her children.,2,na,715287,719920,4633,q,1
219052,41,4,4,16,20,f,Fay.jpg,pieFS4.bmp,Fay received a large inheritance from a distant relative,1,resources,732068,734340,2272,q,1
219052,42,3,4,9,13,m,Alan.jpg,pieFS3.bmp,Alan employs illegal immigrants and pays them less than minimum wage.,1,reputation,746519,749980,3461,p,0
219052,43,2,3,4,7,f,Emily.jpg,pieFS2.bmp,Emily steals her coworkers' tips to buy alcohol.,1,reputation,762134,763660,1526,p,0
219052,44,1,8,8,16,m,Edward.jpg,pieFS1.bmp,Edward could not afford his mortgage and his home was foreclosed.,2,na,775836,777200,1364,q,1
219052,45,3,4,9,13,m,Daniel.jpg,pieFS3.bmp,Daniel is hiding his taxable income in Switzerland.,1,reputation,789387,790141,754,p,0
219052,46,1,9,9,18,m,Jared.jpg,pieFS1.bmp,Jared underreports his company's earnings and pockets the profits.,1,reputation,802339,803461,1122,p,0
219052,47,3,2,4,6,f,Beth.jpg,pieFS3.bmp,Beth is a single mother,2,na,815657,816801,1144,q,1
219052,48,4,2,8,10,f,Monica.jpg,pieFS4.bmp,Monica just lost her small business after a franchise moved in next door.,2,na,828993,830061,1068,q,1
219052,49,3,5,11,16,m,Saul.jpg,pieFS3.bmp,Saul declared bankruptcy after he was laid off.,2,na,842244,843641,1397,q,1
219052,50,5,2,18,20,m,Justin.jpg,pieFS5.bmp,Justin is a well paid lawyer,1,resources,855829,856821,992,q,1
219052,51,3,5,11,16,f,Joanna.jpg,pieFS3.bmp,Joanna used her mother's social security number to open a credit card account.,1,reputation,869014,870621,1607,p,0
219052,52,4,2,8,10,f,Deborah.jpg,pieFS4.bmp,Deborah is raising money to buy gifts for children in need.,2,na,882815,885401,2586,q,1
219089,1,5,1,9,10,m,Taymar.jpg,pieFS5.bmp,Taymar is hiding his taxable income in Switzerland.,1,reputation,46915,52702,5787,z,1
219089,2,3,5,11,16,m,Kevin.jpg,pieFS3.bmp,Kevin lost his house in a fire,2,na,64806,78782,13976,z,1
219089,3,5,2,18,20,m,Brad.jpg,pieFS5.bmp,Brad just found $50 on the street,1,resources,90874,96200,5326,z,1
219089,4,1,8,8,16,m,Darnell.jpg,pieFS1.bmp,Darnell is homeless,2,na,108297,117333,9036,z,1
219089,5,4,3,12,15,m,Nick.jpg,pieFS4.bmp,Nick is saving to pay his university fees,2,na,129449,132349,2900,z,1
219089,6,4,1,4,5,m,George.jpg,pieFS4.bmp,George underreports his company's earnings and pockets the profits.,1,reputation,144448,148413,3965,m,0
219089,7,3,4,9,13,m,Jack.jpg,pieFS3.bmp,Jack lives in a luxury penthouse apartment,1,resources,160500,163117,2617,z,1
219089,8,3,3,7,10,f,Sharon.jpg,pieFS3.bmp,Sharon cannot afford to send her son to college.,2,na,175214,177348,2134,z,1
219089,9,1,9,9,18,m,Daniel.jpg,pieFS1.bmp,Daniel is a well paid lawyer,1,resources,189444,192103,2659,z,1
219089,10,2,6,9,15,m,Jared.jpg,pieFS2.bmp,Jared is a retiree,2,na,204208,206691,2483,z,1
219089,11,4,2,8,10,f,Sammy.jpg,pieFS4.bmp,Sammy takes discarded food from grocery stores to feed her children.,2,na,218789,221015,2226,z,1
219089,12,2,6,9,15,m,Peter.jpg,pieFS2.bmp,Peter stole money from his mother's wallet.,1,reputation,233102,236293,3191,m,0
219089,13,4,4,16,20,f,Jean.jpg,pieFS4.bmp,Jean steals her coworkers' tips to buy alcohol.,1,reputation,248385,250714,2329,m,0
219089,14,5,2,18,20,m,Don.jpg,pieFS5.bmp,Don lost his life savings when his small business failed,2,na,262798,264925,2127,z,1
219089,15,4,2,8,10,m,Michael.jpg,pieFS4.bmp,Michael cheated on his taxes and is now under investigation for tax fraud.,1,reputation,277011,280263,3252,m,0
219089,16,5,1,9,10,m,Ben.jpg,pieFS5.bmp,Ben is a veteran having trouble finding employment.,2,na,292361,294887,2526,z,1
219089,17,4,3,12,15,m,Ricky.jpg,pieFS4.bmp,Ricky just bought an expensive sports car,1,resources,306975,310468,3493,z,1
219089,18,3,2,4,6,f,Emma.jpg,pieFS3.bmp,Emma regularly fires employees to avoid promoting them.,1,reputation,322559,325148,2589,m,0
219089,19,3,4,9,13,m,Saul.jpg,pieFS3.bmp,Saul stole his elderly father's prescription medications.,1,reputation,337240,339623,2383,m,0
219089,20,5,1,9,10,f,Kay.jpg,pieFS5.bmp,Kay secretly gambles with her husband's savings.,1,reputation,351703,354123,2420,m,0
219089,21,4,4,16,20,m,Alan.jpg,pieFS4.bmp,Alan is saving for his son's operation,2,na,366200,368703,2503,z,1
219089,22,5,1,9,10,f,Eileen.jpg,pieFS5.bmp,Eileen just lost her small business after a franchise moved in next door.,2,na,380798,384509,3711,z,1
219089,23,5,2,18,20,m,Tony.jpg,pieFS5.bmp,Tony declared bankruptcy after he was laid off.,2,na,396599,399735,3136,z,1
219089,24,3,5,11,16,f,Janet.jpg,pieFS3.bmp,Janet claims false expenses for her reportable work travel.,1,reputation,411832,414620,2788,m,0
219089,25,3,4,9,13,m,Paul.jpg,pieFS3.bmp,Paul bullies his employees to put in extra hours at work.,1,reputation,426713,429920,3207,m,0
219089,26,4,4,16,20,f,Cindy.jpg,pieFS4.bmp,Cindy used her mother's social security number to open a credit card account.,1,reputation,442013,444994,2981,m,0
219089,27,3,2,4,6,f,Arianna.jpg,pieFS3.bmp,Arianna works as a cleaner in a hotel,2,na,457078,459900,2822,z,1
219089,28,3,3,7,10,m,Mark.jpg,pieFS3.bmp,Mark takes valuables from his friends' homes when asked to house-sit.,1,reputation,471993,474487,2494,m,0
219089,29,3,2,4,6,f,Emily.jpg,pieFS3.bmp,Emily is raising money to buy gifts for children in need.,2,na,486574,488919,2345,z,1
219089,30,5,2,18,20,f,Mary.jpg,pieFS5.bmp,Mary's husband is a wealthy investment banker,1,resources,500988,503848,2860,z,1
219089,31,4,2,8,10,f,Miriam.jpg,pieFS4.bmp,Miriam can't afford to pay her medical bills,2,na,515936,518561,2625,z,1
219089,32,1,10,10,20,f,Fay.jpg,pieFS1.bmp,Fay is going to be evicted because she is behind on her rent,2,na,530650,533885,3235,z,1
219089,33,2,3,4,7,f,Kelly.jpg,pieFS2.bmp,Kelly illegally parks in the disabled parking spots when she can.,1,reputation,545983,548648,2665,m,0
219089,34,3,6,14,20,m,Ian.jpg,pieFS3.bmp,Ian was injured in a hit-and-run accident and cannot afford his medical bills.,2,na,560748,563602,2854,z,1
219089,35,2,8,12,20,f,Fiona.jpg,pieFS2.bmp,Fiona owns an international company,1,resources,575696,578752,3056,z,1
219089,36,4,1,4,5,m,Joe.jpg,pieFS4.bmp,Joe just lost his job,2,na,590846,593291,2445,z,1
219089,37,2,7,10,17,f,Jackie.jpg,pieFS2.bmp,Jackie's car with her bag and credit cards was recently stolen.,2,na,605376,608730,3354,z,1
219089,38,4,3,12,15,f,Deborah.jpg,pieFS4.bmp,Deborah just found out that her husband has incurred a large credit card debt.,2,na,620826,624519,3693,z,1
219089,39,5,1,9,10,m,Matt.jpg,pieFS5.bmp,Matt was mugged and had his wallet stolen.,2,na,636611,639294,2683,z,1
219089,40,5,2,18,20,m,Stuart.jpg,pieFS5.bmp,Stuart often goes through and steals the neighbors' mail.,1,reputation,651392,653937,2545,m,0
219089,41,5,1,9,10,f,Lauren.jpg,pieFS5.bmp,Lauren is a highly paid actress,1,resources,666023,668374,2351,z,1
219089,42,5,1,9,10,f,Maria.jpg,pieFS5.bmp,Maria has to take an unpaid leave of absence because her mother broke her hip.,2,na,680470,682848,2378,z,1
219089,43,4,2,8,10,m,Justin.jpg,pieFS4.bmp,Justin employs illegal immigrants and pays them less than minimum wage.,1,reputation,694933,697098,2165,m,0
219089,44,5,1,9,10,f,Joanna.jpg,pieFS5.bmp,Joanna got a large cash bonus from her boss,1,resources,709179,711403,2224,z,1
219089,45,4,1,4,5,f,Jenny.jpg,pieFS4.bmp,Jenny was a victim of identity theft and is now thousands of dollars in debt.,2,na,723493,725784,2291,z,1
219089,46,4,3,12,15,f,Louise.jpg,pieFS4.bmp,Louise received a large inheritance from a distant relative,1,resources,737873,739809,1936,z,1
219089,47,5,1,9,10,f,Monica.jpg,pieFS5.bmp,Monica works two waitressing jobs to pay her bills.,2,na,751901,754096,2195,z,1
219089,48,2,3,4,7,m,Sam.jpg,pieFS2.bmp,Sam has been unable to find a job for over a year.,2,na,766181,769129,2948,z,1
219089,49,3,2,4,6,f,Trish.jpg,pieFS3.bmp,Trish is a single mother,2,na,781196,783213,2017,z,1
219089,50,1,5,5,10,f,Beth.jpg,pieFS1.bmp,Beth just won the lottery,1,resources,795292,797725,2433,z,1
219089,51,3,6,14,20,m,Edward.jpg,pieFS3.bmp,Edward could not afford his mortgage and his home was foreclosed.,2,na,809823,812331,2508,z,1
219089,52,3,3,7,10,f,Marny.jpg,pieFS3.bmp,Marny just received a huge cash settlement,1,resources,824420,827007,2587,z,1
219144,1,3,5,11,16,m,Joe.jpg,pieFS3.bmp,Joe is saving for his son's operation,2,na,28118,30545,2427,z,1
219144,2,2,3,4,7,f,Lauren.jpg,pieFS2.bmp,Lauren just received a huge cash settlement,1,resources,42648,44493,1845,z,1
219144,3,4,3,12,15,f,Maria.jpg,pieFS4.bmp,Maria takes discarded food from grocery stores to feed her children.,2,na,56610,58612,2002,z,1
219144,4,5,2,18,20,f,Eileen.jpg,pieFS5.bmp,Eileen steals her coworkers' tips to buy alcohol.,1,reputation,70722,72910,2188,m,0
219144,5,4,1,4,5,f,Trish.jpg,pieFS4.bmp,Trish is going to be evicted because she is behind on her rent,2,na,85002,87207,2205,z,1
219144,6,1,5,5,10,f,Miriam.jpg,pieFS1.bmp,Miriam owns an international company,1,resources,99315,101192,1877,z,1
219144,7,5,2,18,20,m,Ian.jpg,pieFS5.bmp,Ian cheated on his taxes and is now under investigation for tax fraud.,1,reputation,113277,117225,3948,m,0
219144,8,2,3,4,7,m,Don.jpg,pieFS2.bmp,Don is a veteran having trouble finding employment.,2,na,129312,130663,1351,z,1
219144,9,3,4,9,13,m,Saul.jpg,pieFS3.bmp,Saul stole his elderly father's prescription medications.,1,reputation,142756,146789,4033,z,1
219144,10,5,1,9,10,m,Peter.jpg,pieFS5.bmp,Peter declared bankruptcy after he was laid off.,2,na,158875,162492,3617,z,1
219144,11,4,2,8,10,f,Monica.jpg,pieFS4.bmp,Monica just lost her small business after a franchise moved in next door.,2,na,174593,178134,3541,z,1
219144,12,1,9,9,18,m,Daniel.jpg,pieFS1.bmp,Daniel bullies his employees to put in extra hours at work.,1,reputation,190227,193025,2798,z,1
219144,13,4,4,16,20,m,George.jpg,pieFS4.bmp,George just lost his job,2,na,205125,206776,1651,z,1
219144,14,4,1,4,5,m,Taymar.jpg,pieFS4.bmp,Taymar employs illegal immigrants and pays them less than minimum wage.,1,reputation,218886,222136,3250,m,0
219144,15,5,1,9,10,f,Janet.jpg,pieFS5.bmp,Janet received a large inheritance from a distant relative,1,resources,234236,236324,2088,m,0
219144,16,4,3,12,15,m,Ben.jpg,pieFS4.bmp,Ben takes valuables from his friends' homes when asked to house-sit.,1,reputation,248415,251481,3066,m,0
219144,17,3,2,4,6,f,Beth.jpg,pieFS3.bmp,Beth is a single mother,2,na,263564,265029,1465,z,1
219144,18,5,2,18,20,m,Nick.jpg,pieFS5.bmp,Nick was injured in a hit-and-run accident and cannot afford his medical bills.,2,na,277125,279686,2561,z,1
219144,19,5,1,9,10,m,Mark.jpg,pieFS5.bmp,Mark was mugged and had his wallet stolen.,2,na,291773,301470,9697,m,0
219144,20,5,1,9,10,f,Sharon.jpg,pieFS5.bmp,Sharon just won the lottery,1,resources,313543,315096,1553,m,0
219144,21,4,2,8,10,m,Tony.jpg,pieFS4.bmp,Tony often goes through and steals the neighbors' mail.,1,reputation,327187,331034,3847,m,0
219144,22,2,7,10,17,f,Emma.jpg,pieFS2.bmp,Emma cannot afford to send her son to college.,2,na,343122,344707,1585,z,1
219144,23,3,3,7,10,f,Emily.jpg,pieFS3.bmp,Emily used her mother's social security number to open a credit card account.,1,reputation,356800,361692,4892,z,1
219144,24,4,1,4,5,m,Kevin.jpg,pieFS4.bmp,Kevin has been unable to find a job for over a year.,2,na,373805,375521,1716,z,1
219144,25,5,1,9,10,f,Jean.jpg,pieFS5.bmp,Jean is raising money to buy gifts for children in need.,2,na,387617,391850,4233,z,1
219144,26,5,1,9,10,f,Mary.jpg,pieFS5.bmp,Mary regularly fires employees to avoid promoting them.,1,reputation,403936,405623,1687,m,0
219144,27,3,2,4,6,f,Jenny.jpg,pieFS3.bmp,Jenny illegally parks in the disabled parking spots when she can.,1,reputation,417714,420883,3169,z,1
219144,28,4,4,16,20,f,Fiona.jpg,pieFS4.bmp,Fiona secretly gambles with her husband's savings.,1,reputation,432980,436962,3982,m,0
219144,29,4,3,12,15,f,Kay.jpg,pieFS4.bmp,Kay claims false expenses for her reportable work travel.,1,reputation,449049,454447,5398,z,1
219144,30,4,3,12,15,m,Alan.jpg,pieFS4.bmp,Alan could not afford his mortgage and his home was foreclosed.,2,na,466539,468865,2326,z,1
219144,31,3,4,9,13,m,Jared.jpg,pieFS3.bmp,Jared is hiding his taxable income in Switzerland.,1,reputation,480953,483417,2464,z,1
219144,32,5,1,9,10,f,Cindy.jpg,pieFS5.bmp,Cindy's car with her bag and credit cards was recently stolen.,2,na,495517,498684,3167,m,0
219144,33,1,10,10,20,f,Arianna.jpg,pieFS1.bmp,Arianna works as a cleaner in a hotel,2,na,510783,512169,1386,z,1
219144,34,3,4,9,13,m,Ricky.jpg,pieFS3.bmp,Ricky underreports his company's earnings and pockets the profits.,1,reputation,524260,526031,1771,z,1
219144,35,3,2,4,6,f,Deborah.jpg,pieFS3.bmp,Deborah just found out that her husband has incurred a large credit card debt.,2,na,538121,539842,1721,z,1
219144,36,4,4,16,20,f,Kelly.jpg,pieFS4.bmp,Kelly is a highly paid actress,1,resources,551933,556718,4785,m,0
219144,37,3,3,7,10,f,Jackie.jpg,pieFS3.bmp,Jackie has to take an unpaid leave of absence because her mother broke her hip.,2,na,568821,571234,2413,z,1
219144,38,2,6,9,15,m,Sam.jpg,pieFS2.bmp,Sam lost his house in a fire,2,na,583335,584736,1401,z,1
219144,39,2,6,9,15,m,Michael.jpg,pieFS2.bmp,Michael just found $50 on the street,1,resources,596828,599329,2501,z,1
219144,40,3,6,14,20,m,Stuart.jpg,pieFS3.bmp,Stuart is homeless,2,na,611409,614893,3484,z,1
219144,41,5,2,18,20,m,Jack.jpg,pieFS5.bmp,Jack is saving to pay his university fees,2,na,626993,631753,4760,m,0
219144,42,5,2,18,20,m,Matt.jpg,pieFS5.bmp,Matt lives in a luxury penthouse apartment,1,resources,643848,646515,2667,m,0
219144,43,4,2,8,10,m,Brad.jpg,pieFS4.bmp,Brad stole money from his mother's wallet.,1,reputation,658595,661926,3331,m,0
219144,44,5,1,9,10,m,Paul.jpg,pieFS5.bmp,Paul is a well paid lawyer,1,resources,673995,675302,1307,m,0
219144,45,1,8,8,16,m,Edward.jpg,pieFS1.bmp,Edward is a retiree,2,na,687372,688740,1368,z,1
219144,46,3,3,7,10,m,Justin.jpg,pieFS3.bmp,Justin just bought an expensive sports car,1,resources,700832,703804,2972,z,1
219144,47,2,8,12,20,f,Sammy.jpg,pieFS2.bmp,Sammy got a large cash bonus from her boss,1,resources,715898,717726,1828,z,1
219144,48,3,6,14,20,m,Darnell.jpg,pieFS3.bmp,Darnell lost his life savings when his small business failed,2,na,729826,732774,2948,z,1
219144,49,4,2,8,10,f,Joanna.jpg,pieFS4.bmp,Joanna was a victim of identity theft and is now thousands of dollars in debt.,2,na,744858,749275,4417,z,1
219144,50,3,5,11,16,f,Louise.jpg,pieFS3.bmp,Louise's husband is a wealthy investment banker,1,resources,761362,764260,2898,z,1
219144,51,5,1,9,10,f,Fay.jpg,pieFS5.bmp,Fay can't afford to pay her medical bills,2,na,776361,778073,1712,z,1
219144,52,3,2,4,6,f,Marny.jpg,pieFS3.bmp,Marny works two waitressing jobs to pay her bills.,2,na,790172,791871,1699,z,1
219471,1,5,1,9,10,f,Sammy.jpg,pieFS5.bmp,Sammy is raising money to buy gifts for children in need.,2,na,55905,58916,3011,q,1
219471,2,3,4,9,13,m,Ben.jpg,pieFS3.bmp,Ben often goes through and steals the neighbors' mail.,1,reputation,71088,73536,2448,p,0
219471,3,5,1,9,10,m,Michael.jpg,pieFS5.bmp,Michael has been unable to find a job for over a year.,2,na,85705,88056,2351,q,1
219471,4,5,1,9,10,m,Mark.jpg,pieFS5.bmp,Mark lost his house in a fire,2,na,100222,102096,1874,q,1
219471,5,5,2,18,20,m,Stuart.jpg,pieFS5.bmp,Stuart just found $50 on the street,1,resources,114273,116356,2083,p,0
219471,6,3,6,14,20,m,Peter.jpg,pieFS3.bmp,Peter is homeless,2,na,128506,130656,2150,q,1
219471,7,3,2,4,6,f,Miriam.jpg,pieFS3.bmp,Miriam is a single mother,2,na,142807,144776,1969,q,1
219471,8,4,3,12,15,m,Tony.jpg,pieFS4.bmp,Tony is saving to pay his university fees,2,na,156925,158736,1811,q,1
219471,9,3,3,7,10,m,Jack.jpg,pieFS3.bmp,Jack lives in a luxury penthouse apartment,1,resources,170892,173416,2524,p,0
219471,10,5,2,18,20,m,Daniel.jpg,pieFS5.bmp,Daniel is a well paid lawyer,1,resources,185576,187456,1880,p,0
219471,11,3,5,11,16,f,Deborah.jpg,pieFS3.bmp,Deborah illegally parks in the disabled parking spots when she can.,1,reputation,199627,201036,1409,p,0
219471,12,2,6,9,15,m,George.jpg,pieFS2.bmp,George is a retiree,2,na,213195,216256,3061,q,1
219471,13,4,2,8,10,f,Kelly.jpg,pieFS4.bmp,Kelly's car with her bag and credit cards was recently stolen.,2,na,228427,230536,2109,q,1
219471,14,5,1,9,10,f,Maria.jpg,pieFS5.bmp,Maria just found out that her husband has incurred a large credit card debt.,2,na,242711,245076,2365,p,0
219471,15,3,3,7,10,f,Beth.jpg,pieFS3.bmp,Beth just won the lottery,1,resources,257228,258737,1509,p,0
219471,16,4,2,8,10,f,Kay.jpg,pieFS4.bmp,Kay cannot afford to send her son to college.,2,na,270896,274097,3201,q,1
219471,17,2,8,12,20,f,Lauren.jpg,pieFS2.bmp,Lauren is a highly paid actress,1,resources,286246,291077,4831,q,1
219471,18,2,6,9,15,m,Edward.jpg,pieFS2.bmp,Edward just bought an expensive sports car,1,resources,303243,310257,7014,q,1
219471,19,3,3,7,10,f,Emily.jpg,pieFS3.bmp,Emily has to take an unpaid leave of absence because her mother broke her hip.,2,na,322438,324577,2139,q,1
219471,20,5,1,9,10,f,Janet.jpg,pieFS5.bmp,Janet regularly fires employees to avoid promoting them.,1,reputation,336756,339557,2801,p,0
219471,21,5,1,9,10,m,Darnell.jpg,pieFS5.bmp,Darnell stole money from his mother's wallet.,1,reputation,351739,355057,3318,p,0
219471,22,3,2,4,6,f,Fiona.jpg,pieFS3.bmp,Fiona secretly gambles with her husband's savings.,1,reputation,367205,379997,12792,q,1
219471,23,4,1,4,5,m,Kevin.jpg,pieFS4.bmp,Kevin lost his life savings when his small business failed,2,na,392160,394737,2577,q,1
219471,24,4,4,16,20,f,Jenny.jpg,pieFS4.bmp,Jenny got a large cash bonus from her boss,1,resources,406893,408517,1624,p,0
219471,25,3,2,4,6,f,Eileen.jpg,pieFS3.bmp,Eileen was a victim of identity theft and is now thousands of dollars in debt.,2,na,420695,422697,2002,q,1
219471,26,4,1,4,5,f,Jackie.jpg,pieFS4.bmp,Jackie works two waitressing jobs to pay her bills.,2,na,434845,436977,2132,q,1
219471,27,1,8,8,16,m,Ricky.jpg,pieFS1.bmp,Ricky is saving for his son's operation,2,na,449129,451497,2368,q,1
219471,28,4,3,12,15,f,Joanna.jpg,pieFS4.bmp,Joanna just received a huge cash settlement,1,resources,463646,465517,1871,p,0
219471,29,2,3,4,7,f,Emma.jpg,pieFS2.bmp,Emma claims false expenses for her reportable work travel.,1,reputation,477664,479317,1653,p,0
219471,30,1,10,10,20,f,Sharon.jpg,pieFS1.bmp,Sharon works as a cleaner in a hotel,2,na,491465,493477,2012,q,1
219471,31,3,4,9,13,m,Justin.jpg,pieFS3.bmp,Justin bullies his employees to put in extra hours at work.,1,reputation,505632,508817,3185,p,0
219471,32,5,1,9,10,f,Mary.jpg,pieFS5.bmp,Mary's husband is a wealthy investment banker,1,resources,520965,522517,1552,p,0
219471,33,5,1,9,10,f,Jean.jpg,pieFS5.bmp,Jean takes discarded food from grocery stores to feed her children.,2,na,534666,537037,2371,q,1
219471,34,4,1,4,5,m,Brad.jpg,pieFS4.bmp,Brad cheated on his taxes and is now under investigation for tax fraud.,1,reputation,549217,551217,2000,p,0
219471,35,3,6,14,20,m,Taymar.jpg,pieFS3.bmp,Taymar just lost his job,2,na,563368,565238,1870,q,1
219471,36,4,2,8,10,m,Joe.jpg,pieFS4.bmp,Joe employs illegal immigrants and pays them less than minimum wage.,1,reputation,577402,579938,2536,p,0
219471,37,3,2,4,6,f,Louise.jpg,pieFS3.bmp,Louise can't afford to pay her medical bills,2,na,592085,594178,2093,q,1
219471,38,2,7,10,17,f,Arianna.jpg,pieFS2.bmp,Arianna is going to be evicted because she is behind on her rent,2,na,606336,608158,1822,q,1
219471,39,2,3,4,7,m,Don.jpg,pieFS2.bmp,Don is a veteran having trouble finding employment.,2,na,620320,621658,1338,q,1
219471,40,4,4,16,20,f,Marny.jpg,pieFS4.bmp,Marny steals her coworkers' tips to buy alcohol.,1,reputation,633805,635638,1833,p,0
219471,41,1,9,9,18,m,Saul.jpg,pieFS1.bmp,Saul stole his elderly father's prescription medications.,1,reputation,647789,649258,1469,p,0
219471,42,1,5,5,10,f,Trish.jpg,pieFS1.bmp,Trish owns an international company,1,resources,661407,666078,4671,q,1
219471,43,4,4,16,20,m,Paul.jpg,pieFS4.bmp,Paul could not afford his mortgage and his home was foreclosed.,2,na,678238,680178,1940,q,1
219471,44,5,2,18,20,m,Nick.jpg,pieFS5.bmp,Nick declared bankruptcy after he was laid off.,2,na,692339,693618,1279,q,1
219471,45,3,4,9,13,m,Ian.jpg,pieFS3.bmp,Ian takes valuables from his friends' homes when asked to house-sit.,1,reputation,705791,707198,1407,p,0
219471,46,4,3,12,15,m,Jared.jpg,pieFS4.bmp,Jared is hiding his taxable income in Switzerland.,1,reputation,719359,720938,1579,p,0
219471,47,4,3,12,15,f,Monica.jpg,pieFS4.bmp,Monica just lost her small business after a franchise moved in next door.,2,na,733093,734898,1805,q,1
219471,48,3,5,11,16,m,Sam.jpg,pieFS3.bmp,Sam was injured in a hit-and-run accident and cannot afford his medical bills.,2,na,747061,748358,1297,q,1
219471,49,5,2,18,20,f,Fay.jpg,pieFS5.bmp,Fay received a large inheritance from a distant relative,1,resources,760513,761958,1445,p,0
219471,50,5,1,9,10,f,Cindy.jpg,pieFS5.bmp,Cindy used her mother's social security number to open a credit card account.,1,reputation,774131,775718,1587,p,0
219471,51,5,2,18,20,m,Matt.jpg,pieFS5.bmp,Matt was mugged and had his wallet stolen.,2,na,787865,790478,2613,q,1
219471,52,4,2,8,10,m,Alan.jpg,pieFS4.bmp,Alan underreports his company's earnings and pockets the profits.,1,reputation,802648,807538,4890,q,1
219675,1,5,1,9,10,f,Jean.jpg,pieFS5.bmp,Jean works two waitressing jobs to pay her bills.,2,na,103065,106120,3055,q,1
219675,2,5,1,9,10,m,Brad.jpg,pieFS5.bmp,Brad declared bankruptcy after he was laid off.,2,na,118315,119520,1205,q,1
219675,3,5,2,18,20,m,Jared.jpg,pieFS5.bmp,Jared bullies his employees to put in extra hours at work.,1,reputation,131717,140300,8583,q,1
219675,4,5,1,9,10,f,Miriam.jpg,pieFS5.bmp,Miriam is a single mother,2,na,152477,153880,1403,q,1
219675,5,3,4,9,13,m,Sam.jpg,pieFS3.bmp,Sam takes valuables from his friends' homes when asked to house-sit.,1,reputation,166078,169181,3103,p,0
219675,6,5,1,9,10,m,Edward.jpg,pieFS5.bmp,Edward just lost his job,2,na,181361,182361,1000,q,1
219675,7,1,8,8,16,m,Nick.jpg,pieFS1.bmp,Nick was injured in a hit-and-run accident and cannot afford his medical bills.,2,na,194530,196221,1691,q,1
219675,8,5,2,18,20,m,Michael.jpg,pieFS5.bmp,Michael was mugged and had his wallet stolen.,2,na,208381,209301,920,q,1
219675,9,4,2,8,10,m,Daniel.jpg,pieFS4.bmp,Daniel employs illegal immigrants and pays them less than minimum wage.,1,reputation,221483,223001,1518,p,0
219675,10,4,2,8,10,m,Stuart.jpg,pieFS4.bmp,Stuart often goes through and steals the neighbors' mail.,1,reputation,235151,237181,2030,p,0
219675,11,4,4,16,20,m,Tony.jpg,pieFS4.bmp,Tony has been unable to find a job for over a year.,2,na,249352,250021,669,q,1
219675,12,3,6,14,20,m,Kevin.jpg,pieFS3.bmp,Kevin lost his house in a fire,2,na,262171,263142,971,q,1
219675,13,4,4,16,20,f,Jenny.jpg,pieFS4.bmp,Jenny just received a huge cash settlement,1,resources,275289,276602,1313,q,1
219675,14,3,2,4,6,f,Kay.jpg,pieFS3.bmp,Kay just won the lottery,1,resources,288774,290542,1768,q,1
219675,15,3,3,7,10,m,Don.jpg,pieFS3.bmp,Don just found $50 on the street,1,resources,302759,304222,1463,q,1
219675,16,4,3,12,15,m,Taymar.jpg,pieFS4.bmp,Taymar could not afford his mortgage and his home was foreclosed.,2,na,316760,318002,1242,q,1
219675,17,1,10,10,20,f,Louise.jpg,pieFS1.bmp,Louise cannot afford to send her son to college.,2,na,330228,331923,1695,q,1
219675,18,3,4,9,13,m,Paul.jpg,pieFS3.bmp,Paul is hiding his taxable income in Switzerland.,1,reputation,344129,348823,4694,p,0
219675,19,1,9,9,18,m,Joe.jpg,pieFS1.bmp,Joe underreports his company's earnings and pockets the profits.,1,reputation,361027,362283,1256,p,0
219675,20,5,1,9,10,f,Sharon.jpg,pieFS5.bmp,Sharon regularly fires employees to avoid promoting them.,1,reputation,374528,375823,1295,p,0
219675,21,2,6,9,15,m,Ian.jpg,pieFS2.bmp,Ian is homeless,2,na,388080,388883,803,q,1
219675,22,5,2,18,20,m,George.jpg,pieFS5.bmp,George is a well paid lawyer,1,resources,401099,402643,1544,q,1
219675,23,5,2,18,20,f,Beth.jpg,pieFS5.bmp,Beth secretly gambles with her husband's savings.,1,reputation,414867,416023,1156,p,0
219675,24,3,6,14,20,m,Darnell.jpg,pieFS3.bmp,Darnell is saving to pay his university fees,2,na,428252,429404,1152,q,1
219675,25,5,1,9,10,f,Janet.jpg,pieFS5.bmp,Janet claims false expenses for her reportable work travel.,1,reputation,441620,443424,1804,p,0
219675,26,4,1,4,5,m,Ricky.jpg,pieFS4.bmp,Ricky is a retiree,2,na,455638,456664,1026,q,1
219675,27,5,1,9,10,m,Mark.jpg,pieFS5.bmp,Mark lives in a luxury penthouse apartment,1,resources,468873,469804,931,q,1
219675,28,3,3,7,10,f,Fay.jpg,pieFS3.bmp,Fay works as a cleaner in a hotel,2,na,482008,483504,1496,q,1
219675,29,4,1,4,5,m,Jack.jpg,pieFS4.bmp,Jack stole money from his mother's wallet.,1,reputation,495726,497224,1498,p,0
219675,30,4,2,8,10,f,Maria.jpg,pieFS4.bmp,Maria takes discarded food from grocery stores to feed her children.,2,na,509428,511004,1576,q,1
219675,31,3,4,9,13,m,Justin.jpg,pieFS3.bmp,Justin just bought an expensive sports car,1,resources,523212,524544,1332,q,1
219675,32,2,3,4,7,f,Emily.jpg,pieFS2.bmp,Emily steals her coworkers' tips to buy alcohol.,1,reputation,536747,537765,1018,p,0
219675,33,5,2,18,20,m,Peter.jpg,pieFS5.bmp,Peter lost his life savings when his small business failed,2,na,549982,551985,2003,q,1
219675,34,3,2,4,6,f,Lauren.jpg,pieFS3.bmp,Lauren just lost her small business after a franchise moved in next door.,2,na,564200,565225,1025,q,1
219675,35,2,8,12,20,f,Cindy.jpg,pieFS2.bmp,Cindy used her mother's social security number to open a credit card account.,1,reputation,577452,579845,2393,p,0
219675,36,2,6,9,15,m,Matt.jpg,pieFS2.bmp,Matt cheated on his taxes and is now under investigation for tax fraud.,1,reputation,592069,592865,796,p,0
219675,37,4,3,12,15,f,Mary.jpg,pieFS4.bmp,Mary's husband is a wealthy investment banker,1,resources,605087,606046,959,q,1
219675,38,4,2,8,10,f,Fiona.jpg,pieFS4.bmp,Fiona can't afford to pay her medical bills,2,na,618273,619466,1193,q,1
219675,39,5,1,9,10,f,Jackie.jpg,pieFS5.bmp,Jackie is raising money to buy gifts for children in need.,2,na,631674,632386,712,q,1
219675,40,2,3,4,7,m,Alan.jpg,pieFS2.bmp,Alan is saving for his son's operation,2,na,644560,645786,1226,q,1
219675,41,3,5,11,16,f,Kelly.jpg,pieFS3.bmp,Kelly illegally parks in the disabled parking spots when she can.,1,reputation,657962,659066,1104,q,1
219675,42,3,5,11,16,m,Saul.jpg,pieFS3.bmp,Saul is a veteran having trouble finding employment.,2,na,671214,672146,932,q,1
219675,43,4,1,4,5,f,Marny.jpg,pieFS4.bmp,Marny's car with her bag and credit cards was recently stolen.,2,na,684316,685426,1110,q,1
219675,44,2,7,10,17,f,Trish.jpg,pieFS2.bmp,Trish is going to be evicted because she is behind on her rent,2,na,697584,698666,1082,q,1
219675,45,4,3,12,15,f,Deborah.jpg,pieFS4.bmp,Deborah just found out that her husband has incurred a large credit card debt.,2,na,710853,712146,1293,q,1
219675,46,3,3,7,10,f,Arianna.jpg,pieFS3.bmp,Arianna owns an international company,1,resources,724338,725087,749,q,1
219675,47,4,4,16,20,f,Monica.jpg,pieFS4.bmp,Monica is a highly paid actress,1,resources,737256,738247,991,q,1
219675,48,1,5,5,10,f,Emma.jpg,pieFS1.bmp,Emma received a large inheritance from a distant relative,1,resources,750442,751487,1045,q,1
219675,49,3,2,4,6,f,Sammy.jpg,pieFS3.bmp,Sammy has to take an unpaid leave of absence because her mother broke her hip.,2,na,763677,764267,590,q,1
219675,50,5,1,9,10,f,Joanna.jpg,pieFS5.bmp,Joanna got a large cash bonus from her boss,1,resources,776446,777227,781,q,1
219675,51,4,3,12,15,m,Ben.jpg,pieFS4.bmp,Ben stole his elderly father's prescription medications.,1,reputation,789398,790427,1029,p,0
219675,52,3,2,4,6,f,Eileen.jpg,pieFS3.bmp,Eileen was a victim of identity theft and is now thousands of dollars in debt.,2,na,802617,803147,530,q,1
219698,1,3,4,9,13,m,Taymar.jpg,pieFS3.bmp,Taymar is hiding his taxable income in Switzerland.,1,reputation,46335,53801,7466,p,0
219698,2,4,2,8,10,m,George.jpg,pieFS4.bmp,George underreports his company's earnings and pockets the profits.,1,reputation,65996,71561,5565,p,0
219698,3,1,10,10,20,f,Joanna.jpg,pieFS1.bmp,Joanna works two waitressing jobs to pay her bills.,2,na,83759,86621,2862,q,1
219698,4,2,6,9,15,m,Kevin.jpg,pieFS2.bmp,Kevin is a veteran having trouble finding employment.,2,na,98826,103122,4296,q,1
219698,5,3,2,4,6,f,Emma.jpg,pieFS3.bmp,Emma cannot afford to send her son to college.,2,na,115308,117782,2474,q,1
219698,6,4,4,16,20,f,Fay.jpg,pieFS4.bmp,Fay regularly fires employees to avoid promoting them.,1,reputation,129941,135022,5081,p,0
219698,7,4,1,4,5,m,Nick.jpg,pieFS4.bmp,Nick stole his elderly father's prescription medications.,1,reputation,147205,151822,4617,p,0
219698,8,2,3,4,7,m,Tony.jpg,pieFS2.bmp,Tony declared bankruptcy after he was laid off.,2,na,164020,169682,5662,q,1
219698,9,5,2,18,20,m,Peter.jpg,pieFS5.bmp,Peter takes valuables from his friends' homes when asked to house-sit.,1,reputation,181850,185242,3392,p,0
219698,10,2,3,4,7,f,Arianna.jpg,pieFS2.bmp,Arianna secretly gambles with her husband's savings.,1,reputation,197399,202263,4864,p,0
219698,11,3,2,4,6,f,Mary.jpg,pieFS3.bmp,Mary claims false expenses for her reportable work travel.,1,reputation,214413,217323,2910,p,0
219698,12,3,4,9,13,m,Justin.jpg,pieFS3.bmp,Justin is a well paid lawyer,1,resources,229480,234543,5063,q,1
219698,13,4,4,16,20,m,Stuart.jpg,pieFS4.bmp,Stuart was injured in a hit-and-run accident and cannot afford his medical bills.,2,na,246727,250323,3596,q,1
219698,14,4,3,12,15,f,Louise.jpg,pieFS4.bmp,Louise works as a cleaner in a hotel,2,na,262476,268883,6407,q,1
219698,15,5,2,18,20,m,Darnell.jpg,pieFS5.bmp,Darnell was mugged and had his wallet stolen.,2,na,281072,285164,4092,q,1
219698,16,2,6,9,15,m,Brad.jpg,pieFS2.bmp,Brad often goes through and steals the neighbors' mail.,1,reputation,297354,299824,2470,p,0
219698,17,3,6,14,20,m,Ian.jpg,pieFS3.bmp,Ian has been unable to find a job for over a year.,2,na,311988,328704,16716,q,1
219698,18,2,8,12,20,f,Kelly.jpg,pieFS2.bmp,Kelly just received a huge cash settlement,1,resources,340855,345324,4469,q,1
219698,19,5,1,9,10,f,Cindy.jpg,pieFS5.bmp,Cindy takes discarded food from grocery stores to feed her children.,2,na,357504,362624,5120,q,1
219698,20,5,2,18,20,f,Emily.jpg,pieFS5.bmp,Emily steals her coworkers' tips to buy alcohol.,1,reputation,374784,376084,1300,p,0
219698,21,3,2,4,6,f,Monica.jpg,pieFS3.bmp,Monica just lost her small business after a franchise moved in next door.,2,na,388269,390365,2096,q,1
219698,22,5,1,9,10,m,Daniel.jpg,pieFS5.bmp,Daniel is a retiree,2,na,402520,407465,4945,q,1
219698,23,5,1,9,10,f,Miriam.jpg,pieFS5.bmp,Miriam's husband is a wealthy investment banker,1,resources,419634,424525,4891,p,0
219698,24,4,3,12,15,m,Don.jpg,pieFS4.bmp,Don lost his house in a fire,2,na,436682,440365,3683,q,1
219698,25,3,3,7,10,f,Sammy.jpg,pieFS3.bmp,Sammy used her mother's social security number to open a credit card account.,1,reputation,452547,454545,1998,p,0
219698,26,3,4,9,13,m,Mark.jpg,pieFS3.bmp,Mark just found $50 on the street,1,resources,466698,471605,4907,q,1
219698,27,4,2,8,10,f,Trish.jpg,pieFS4.bmp,Trish can't afford to pay her medical bills,2,na,483762,487666,3904,q,1
219698,28,4,3,12,15,m,Alan.jpg,pieFS4.bmp,Alan just bought an expensive sports car,1,resources,499844,505246,5402,q,1
219698,29,5,1,9,10,m,Edward.jpg,pieFS5.bmp,Edward is saving for his son's operation,2,na,517425,519306,1881,q,1
219698,30,2,7,10,17,f,Marny.jpg,pieFS2.bmp,Marny is raising money to buy gifts for children in need.,2,na,531492,534306,2814,q,1
219698,31,5,2,18,20,m,Joe.jpg,pieFS5.bmp,Joe bullies his employees to put in extra hours at work.,1,reputation,546476,550126,3650,p,0
219698,32,3,3,7,10,f,Fiona.jpg,pieFS3.bmp,Fiona is going to be evicted because she is behind on her rent,2,na,562275,567527,5252,q,1
219698,33,3,6,14,20,m,Saul.jpg,pieFS3.bmp,Saul is homeless,2,na,579689,584127,4438,q,1
219698,34,5,1,9,10,f,Sharon.jpg,pieFS5.bmp,Sharon owns an international company,1,resources,596287,602867,6580,p,0
219698,35,5,2,18,20,m,Jack.jpg,pieFS5.bmp,Jack is saving to pay his university fees,2,na,615016,617987,2971,q,1
219698,36,4,3,12,15,f,Maria.jpg,pieFS4.bmp,Maria illegally parks in the disabled parking spots when she can.,1,reputation,630166,631967,1801,p,0
219698,37,1,9,9,18,m,Michael.jpg,pieFS1.bmp,Michael lives in a luxury penthouse apartment,1,resources,644117,650207,6090,q,1
219698,38,3,3,7,10,m,Sam.jpg,pieFS3.bmp,Sam stole money from his mother's wallet.,1,reputation,662363,665547,3184,p,0
219698,39,3,2,4,6,f,Eileen.jpg,pieFS3.bmp,Eileen's car with her bag and credit cards was recently stolen.,2,na,677696,682008,4312,q,1
219698,40,4,1,4,5,f,Jackie.jpg,pieFS4.bmp,Jackie just found out that her husband has incurred a large credit card debt.,2,na,694194,698848,4654,q,1
219698,41,5,1,9,10,f,Lauren.jpg,pieFS5.bmp,Lauren is a highly paid actress,1,resources,711009,714468,3459,p,0
219698,42,4,2,8,10,f,Jenny.jpg,pieFS4.bmp,Jenny has to take an unpaid leave of absence because her mother broke her hip.,2,na,726658,732188,5530,q,1
219698,43,4,1,4,5,m,Ricky.jpg,pieFS4.bmp,Ricky just lost his job,2,na,744338,748748,4410,q,1
219698,44,3,5,11,16,m,Matt.jpg,pieFS3.bmp,Matt lost his life savings when his small business failed,2,na,760919,763408,2489,q,1
219698,45,3,5,11,16,f,Jean.jpg,pieFS3.bmp,Jean got a large cash bonus from her boss,1,resources,775586,777889,2303,q,1
219698,46,4,2,8,10,m,Jared.jpg,pieFS4.bmp,Jared employs illegal immigrants and pays them less than minimum wage.,1,reputation,790070,792529,2459,p,0
219698,47,5,1,9,10,m,Ben.jpg,pieFS5.bmp,Ben cheated on his taxes and is now under investigation for tax fraud.,1,reputation,804704,810069,5365,p,0
219698,48,1,5,5,10,f,Kay.jpg,pieFS1.bmp,Kay received a large inheritance from a distant relative,1,resources,822251,825489,3238,q,1
219698,49,5,1,9,10,f,Beth.jpg,pieFS5.bmp,Beth is a single mother,2,na,837684,841029,3345,q,1
219698,50,4,4,16,20,f,Janet.jpg,pieFS4.bmp,Janet just won the lottery,1,resources,853216,863610,10394,q,1
219698,51,1,8,8,16,m,Paul.jpg,pieFS1.bmp,Paul could not afford his mortgage and his home was foreclosed.,2,na,875758,879490,3732,q,1
219698,52,5,1,9,10,f,Deborah.jpg,pieFS5.bmp,Deborah was a victim of identity theft and is now thousands of dollars in debt.,2,na,891657,895070,3413,q,1
219772,1,4,4,16,20,m,Alan.jpg,pieFS4.bmp,Alan is a retiree,2,na,90475,94443,3968,q,1
219772,2,2,8,12,20,f,Arianna.jpg,pieFS2.bmp,Arianna just won the lottery,1,resources,106740,109543,2803,q,1
219772,3,5,1,9,10,f,Sharon.jpg,pieFS5.bmp,Sharon cannot afford to send her son to college.,2,na,121840,125423,3583,q,1
219772,4,2,6,9,15,m,Matt.jpg,pieFS2.bmp,Matt takes valuables from his friends' homes when asked to house-sit.,1,reputation,137739,141344,3605,p,0
219772,5,3,4,9,13,m,Joe.jpg,pieFS3.bmp,Joe just bought an expensive sports car,1,resources,153655,156284,2629,q,1
219772,6,2,6,9,15,m,Nick.jpg,pieFS2.bmp,Nick was injured in a hit-and-run accident and cannot afford his medical bills.,2,na,168571,170804,2233,q,1
219772,7,3,5,11,16,f,Janet.jpg,pieFS3.bmp,Janet regularly fires employees to avoid promoting them.,1,reputation,183105,185944,2839,p,0
219772,8,5,1,9,10,m,Tony.jpg,pieFS5.bmp,Tony was mugged and had his wallet stolen.,2,na,198238,200965,2727,q,1
219772,9,5,2,18,20,m,Ricky.jpg,pieFS5.bmp,Ricky is saving for his son's operation,2,na,213288,215125,1837,q,1
219772,10,4,3,12,15,m,Don.jpg,pieFS4.bmp,Don often goes through and steals the neighbors' mail.,1,reputation,227373,229505,2132,p,0
219772,11,4,1,4,5,m,Stuart.jpg,pieFS4.bmp,Stuart has been unable to find a job for over a year.,2,na,241790,244926,3136,q,1
219772,12,5,1,9,10,m,Sam.jpg,pieFS5.bmp,Sam lost his house in a fire,2,na,257223,259226,2003,q,1
219772,13,5,1,9,10,f,Fay.jpg,pieFS5.bmp,Fay secretly gambles with her husband's savings.,1,reputation,271507,275926,4419,p,0
219772,14,4,2,8,10,m,Michael.jpg,pieFS4.bmp,Michael just found $50 on the street,1,resources,288238,291647,3409,q,1
219772,15,5,1,9,10,f,Marny.jpg,pieFS5.bmp,Marny was a victim of identity theft and is now thousands of dollars in debt.,2,na,303971,305527,1556,q,1
219772,16,3,3,7,10,m,Edward.jpg,pieFS3.bmp,Edward bullies his employees to put in extra hours at work.,1,reputation,317839,320867,3028,q,1
219772,17,4,4,16,20,f,Kay.jpg,pieFS4.bmp,Kay claims false expenses for her reportable work travel.,1,reputation,333205,335428,2223,p,0
219772,18,4,3,12,15,m,Ben.jpg,pieFS4.bmp,Ben is homeless,2,na,347739,350248,2509,p,0
219772,19,2,3,4,7,m,Darnell.jpg,pieFS2.bmp,Darnell is saving to pay his university fees,2,na,362556,364888,2332,q,1
219772,20,5,1,9,10,f,Maria.jpg,pieFS5.bmp,Maria works two waitressing jobs to pay her bills.,2,na,377206,378888,1682,q,1
219772,21,4,1,4,5,m,Brad.jpg,pieFS4.bmp,Brad lives in a luxury penthouse apartment,1,resources,391191,394128,2937,p,0
219772,22,5,1,9,10,f,Sammy.jpg,pieFS5.bmp,Sammy just received a huge cash settlement,1,resources,406391,409629,3238,p,0
219772,23,4,1,4,5,f,Eileen.jpg,pieFS4.bmp,Eileen takes discarded food from grocery stores to feed her children.,2,na,421890,424389,2499,q,1
219772,24,3,2,4,6,f,Lauren.jpg,pieFS3.bmp,Lauren steals her coworkers' tips to buy alcohol.,1,reputation,436707,439909,3202,q,1
219772,25,3,2,4,6,f,Mary.jpg,pieFS3.bmp,Mary works as a cleaner in a hotel,2,na,452240,454190,1950,q,1
219772,26,2,7,10,17,f,Emily.jpg,pieFS2.bmp,Emily just lost her small business after a franchise moved in next door.,2,na,466540,468690,2150,q,1
219772,27,4,4,16,20,f,Kelly.jpg,pieFS4.bmp,Kelly used her mother's social security number to open a credit card account.,1,reputation,480991,483390,2399,p,0
219772,28,5,1,9,10,m,Mark.jpg,pieFS5.bmp,Mark stole money from his mother's wallet.,1,reputation,495692,498031,2339,p,0
219772,29,3,2,4,6,f,Jean.jpg,pieFS3.bmp,Jean is raising money to buy gifts for children in need.,2,na,510309,512491,2182,q,1
219772,30,3,5,11,16,m,Daniel.jpg,pieFS3.bmp,Daniel just lost his job,2,na,524776,527271,2495,q,1
219772,31,5,1,9,10,f,Deborah.jpg,pieFS5.bmp,Deborah illegally parks in the disabled parking spots when she can.,1,reputation,539576,542852,3276,p,0
219772,32,3,3,7,10,f,Beth.jpg,pieFS3.bmp,Beth's husband is a wealthy investment banker,1,resources,555159,557292,2133,q,1
219772,33,1,10,10,20,f,Emma.jpg,pieFS1.bmp,Emma can't afford to pay her medical bills,2,na,569610,571692,2082,q,1
219772,34,4,2,8,10,f,Joanna.jpg,pieFS4.bmp,Joanna's car with her bag and credit cards was recently stolen.,2,na,584010,586492,2482,q,1
219772,35,4,2,8,10,f,Miriam.jpg,pieFS4.bmp,Miriam is going to be evicted because she is behind on her rent,2,na,598794,600572,1778,q,1
219772,36,4,3,12,15,f,Jackie.jpg,pieFS4.bmp,Jackie just found out that her husband has incurred a large credit card debt.,2,na,612911,614713,1802,q,1
219772,37,3,6,14,20,m,Saul.jpg,pieFS3.bmp,Saul lost his life savings when his small business failed,2,na,627029,628813,1784,q,1
219772,38,5,2,18,20,m,Justin.jpg,pieFS5.bmp,Justin employs illegal immigrants and pays them less than minimum wage.,1,reputation,641147,645193,4046,p,0
219772,39,1,8,8,16,m,Jared.jpg,pieFS1.bmp,Jared could not afford his mortgage and his home was foreclosed.,2,na,657495,659574,2079,q,1
219772,40,2,3,4,7,f,Monica.jpg,pieFS2.bmp,Monica is a highly paid actress,1,resources,671879,674454,2575,q,1
219772,41,3,4,9,13,m,Peter.jpg,pieFS3.bmp,Peter cheated on his taxes and is now under investigation for tax fraud.,1,reputation,686729,689154,2425,q,1
219772,42,3,2,4,6,f,Cindy.jpg,pieFS3.bmp,Cindy has to take an unpaid leave of absence because her mother broke her hip.,2,na,701463,703134,1671,q,1
219772,43,1,5,5,10,f,Fiona.jpg,pieFS1.bmp,Fiona owns an international company,1,resources,715448,717135,1687,q,1
219772,44,5,2,18,20,m,Jack.jpg,pieFS5.bmp,Jack is a veteran having trouble finding employment.,2,na,729449,731095,1646,q,1
219772,45,5,2,18,20,f,Louise.jpg,pieFS5.bmp,Louise received a large inheritance from a distant relative,1,resources,743367,745495,2128,p,0
219772,46,3,3,7,10,f,Trish.jpg,pieFS3.bmp,Trish is a single mother,2,na,757784,759416,1632,q,1
219772,47,5,2,18,20,m,Kevin.jpg,pieFS5.bmp,Kevin stole his elderly father's prescription medications.,1,reputation,771719,773776,2057,p,0
219772,48,4,3,12,15,f,Jenny.jpg,pieFS4.bmp,Jenny got a large cash bonus from her boss,1,resources,786086,790076,3990,q,1
219772,49,3,6,14,20,m,Ian.jpg,pieFS3.bmp,Ian declared bankruptcy after he was laid off.,2,na,802401,804136,1735,q,1
219772,50,3,4,9,13,m,Paul.jpg,pieFS3.bmp,Paul is hiding his taxable income in Switzerland.,1,reputation,816419,819617,3198,q,1
219772,51,4,2,8,10,m,George.jpg,pieFS4.bmp,George underreports his company's earnings and pockets the profits.,1,reputation,831918,834277,2359,p,0
219772,52,1,9,9,18,m,Taymar.jpg,pieFS1.bmp,Taymar is a well paid lawyer,1,resources,846552,848757,2205,q,1
220041,1,3,2,4,6,f,Trish.jpg,pieFS3.bmp,Trish works as a cleaner in a hotel,2,na,88247,114623,26376,q,1
220041,2,1,5,5,10,f,Sharon.jpg,pieFS1.bmp,Sharon's husband is a wealthy investment banker,1,resources,126870,131536,4666,q,1
220041,3,1,9,9,18,m,Paul.jpg,pieFS1.bmp,Paul is a well paid lawyer,1,resources,143768,147696,3928,q,1
220041,4,4,3,12,15,f,Janet.jpg,pieFS4.bmp,Janet can't afford to pay her medical bills,2,na,159950,167957,8007,q,1
220041,5,3,2,4,6,f,Jackie.jpg,pieFS3.bmp,Jackie takes discarded food from grocery stores to feed her children.,2,na,180194,184017,3823,q,1
220041,6,4,2,8,10,f,Emma.jpg,pieFS4.bmp,Emma is going to be evicted because she is behind on her rent,2,na,196243,198977,2734,q,1
220041,7,4,1,4,5,m,Peter.jpg,pieFS4.bmp,Peter is a veteran having trouble finding employment.,2,na,211193,214637,3444,q,1
220041,8,2,6,9,15,m,Justin.jpg,pieFS2.bmp,Justin is a retiree,2,na,226859,229577,2718,q,1
220041,9,5,2,18,20,f,Lauren.jpg,pieFS5.bmp,Lauren steals her coworkers' tips to buy alcohol.,1,reputation,241825,246017,4192,p,0
220041,10,5,1,9,10,f,Fay.jpg,pieFS5.bmp,Fay owns an international company,1,resources,258240,263817,5577,p,0
220041,11,5,1,9,10,m,Tony.jpg,pieFS5.bmp,Tony stole his elderly father's prescription medications.,1,reputation,276054,280058,4004,p,0
220041,12,3,3,7,10,f,Eileen.jpg,pieFS3.bmp,Eileen just lost her small business after a franchise moved in next door.,2,na,292286,296198,3912,q,1
220041,13,5,1,9,10,f,Kay.jpg,pieFS5.bmp,Kay received a large inheritance from a distant relative,1,resources,308417,314978,6561,p,0
220041,14,4,4,16,20,f,Kelly.jpg,pieFS4.bmp,Kelly used her mother's social security number to open a credit card account.,1,reputation,327180,329358,2178,p,0
220041,15,1,10,10,20,f,Beth.jpg,pieFS1.bmp,Beth is a single mother,2,na,341580,345498,3918,q,1
220041,16,4,1,4,5,m,Daniel.jpg,pieFS4.bmp,Daniel just bought an expensive sports car,1,resources,357746,360698,2952,p,0
220041,17,4,1,4,5,f,Jean.jpg,pieFS4.bmp,Jean is raising money to buy gifts for children in need.,2,na,372929,378379,5450,q,1
220041,18,4,4,16,20,f,Mary.jpg,pieFS4.bmp,Mary just won the lottery,1,resources,390609,396679,6070,p,0
220041,19,5,1,9,10,m,Sam.jpg,pieFS5.bmp,Sam declared bankruptcy after he was laid off.,2,na,408905,413219,4314,q,1
220041,20,3,2,4,6,f,Miriam.jpg,pieFS3.bmp,Miriam cannot afford to send her son to college.,2,na,425437,454054,28617,p,0
220041,21,3,3,7,10,m,Michael.jpg,pieFS3.bmp,Michael takes valuables from his friends' homes when asked to house-sit.,1,reputation,466274,492538,26264,p,0
220041,22,3,3,7,10,f,Louise.jpg,pieFS3.bmp,Louise regularly fires employees to avoid promoting them.,1,reputation,504781,507180,2399,p,0
220041,23,3,6,14,20,m,Jared.jpg,pieFS3.bmp,Jared is saving for his son's operation,2,na,519415,523220,3805,q,1
220041,24,5,2,18,20,m,Ricky.jpg,pieFS5.bmp,Ricky bullies his employees to put in extra hours at work.,1,reputation,535447,539060,3613,p,0
220041,25,2,3,4,7,f,Emily.jpg,pieFS2.bmp,Emily illegally parks in the disabled parking spots when she can.,1,reputation,551296,554640,3344,p,0
220041,26,5,1,9,10,f,Jenny.jpg,pieFS5.bmp,Jenny's car with her bag and credit cards was recently stolen.,2,na,566862,569701,2839,p,0
220041,27,4,2,8,10,f,Monica.jpg,pieFS4.bmp,Monica just found out that her husband has incurred a large credit card debt.,2,na,581928,585701,3773,p,0
220041,28,2,3,4,7,m,Joe.jpg,pieFS2.bmp,Joe just lost his job,2,na,597927,600581,2654,q,1
220041,29,5,2,18,20,m,George.jpg,pieFS5.bmp,George employs illegal immigrants and pays them less than minimum wage.,1,reputation,612811,616361,3550,p,0
220041,30,5,1,9,10,m,Don.jpg,pieFS5.bmp,Don was injured in a hit-and-run accident and cannot afford his medical bills.,2,na,628593,631581,2988,q,1
220041,31,5,2,18,20,m,Darnell.jpg,pieFS5.bmp,Darnell was mugged and had his wallet stolen.,2,na,643809,646681,2872,q,1
220041,32,5,2,18,20,m,Edward.jpg,pieFS5.bmp,Edward could not afford his mortgage and his home was foreclosed.,2,na,658909,661841,2932,q,1
220041,33,3,4,9,13,m,Brad.jpg,pieFS3.bmp,Brad often goes through and steals the neighbors' mail.,1,reputation,674059,676262,2203,p,0
220041,34,3,5,11,16,m,Matt.jpg,pieFS3.bmp,Matt has been unable to find a job for over a year.,2,na,688476,690962,2486,q,1
220041,35,4,3,12,15,f,Deborah.jpg,pieFS4.bmp,Deborah is a highly paid actress,1,resources,703176,706562,3386,p,0
220041,36,3,2,4,6,f,Arianna.jpg,pieFS3.bmp,Arianna secretly gambles with her husband's savings.,1,reputation,718792,720522,1730,p,0
220041,37,4,2,8,10,m,Alan.jpg,pieFS4.bmp,Alan is hiding his taxable income in Switzerland.,1,reputation,732743,735302,2559,p,0
220041,38,2,7,10,17,f,Cindy.jpg,pieFS2.bmp,Cindy has to take an unpaid leave of absence because her mother broke her hip.,2,na,747510,750582,3072,q,1
220041,39,4,3,12,15,m,Ben.jpg,pieFS4.bmp,Ben lost his house in a fire,2,na,762793,765763,2970,q,1
220041,40,5,1,9,10,f,Sammy.jpg,pieFS5.bmp,Sammy got a large cash bonus from her boss,1,resources,777993,780263,2270,p,0
220041,41,2,8,12,20,f,Fiona.jpg,pieFS2.bmp,Fiona claims false expenses for her reportable work travel.,1,reputation,792493,795783,3290,p,0
220041,42,4,3,12,15,m,Jack.jpg,pieFS4.bmp,Jack just found $50 on the street,1,resources,808009,810703,2694,p,0
220041,43,4,4,16,20,m,Saul.jpg,pieFS4.bmp,Saul is homeless,2,na,822893,825623,2730,q,1
220041,44,5,1,9,10,f,Maria.jpg,pieFS5.bmp,Maria was a victim of identity theft and is now thousands of dollars in debt.,2,na,837826,841423,3597,q,1
220041,45,5,1,9,10,f,Joanna.jpg,pieFS5.bmp,Joanna works two waitressing jobs to pay her bills.,2,na,853641,856304,2663,q,1
220041,46,1,8,8,16,m,Nick.jpg,pieFS1.bmp,Nick is saving to pay his university fees,2,na,868525,871024,2499,q,1
220041,47,2,6,9,15,m,Kevin.jpg,pieFS2.bmp,Kevin lives in a luxury penthouse apartment,1,resources,883225,886544,3319,p,0
220041,48,3,4,9,13,m,Taymar.jpg,pieFS3.bmp,Taymar underreports his company's earnings and pockets the profits.,1,reputation,898758,902064,3306,p,0
220041,49,4,2,8,10,m,Ian.jpg,pieFS4.bmp,Ian stole money from his mother's wallet.,1,reputation,914290,916824,2534,p,0
220041,50,3,5,11,16,f,Marny.jpg,pieFS3.bmp,Marny just received a huge cash settlement,1,resources,929041,935744,6703,p,0
220041,51,3,6,14,20,m,Mark.jpg,pieFS3.bmp,Mark lost his life savings when his small business failed,2,na,947969,950445,2476,q,1
220041,52,3,4,9,13,m,Stuart.jpg,pieFS3.bmp,Stuart cheated on his taxes and is now under investigation for tax fraud.,1,reputation,962670,964505,1835,p,0
220043,1,4,2,8,10,f,Mary.jpg,pieFS4.bmp,Mary can't afford to pay her medical bills,2,na,51687,58796,7109,q,1
220043,2,5,1,9,10,f,Kay.jpg,pieFS5.bmp,Kay is going to be evicted because she is behind on her rent,2,na,71049,73596,2547,q,1
220043,3,5,1,9,10,m,Mark.jpg,pieFS5.bmp,Mark declared bankruptcy after he was laid off.,2,na,85799,87777,1978,q,1
220043,4,4,2,8,10,m,Ian.jpg,pieFS4.bmp,Ian takes valuables from his friends' homes when asked to house-sit.,1,reputation,100000,104077,4077,p,0
220043,5,2,8,12,20,f,Janet.jpg,pieFS2.bmp,Janet owns an international company,1,resources,116332,118677,2345,q,1
220043,6,5,1,9,10,m,Brad.jpg,pieFS5.bmp,Brad was injured in a hit-and-run accident and cannot afford his medical bills.,2,na,130916,133318,2402,q,1
220043,7,5,2,18,20,f,Miriam.jpg,pieFS5.bmp,Miriam received a large inheritance from a distant relative,1,resources,145533,147938,2405,p,0
220043,8,4,1,4,5,m,Taymar.jpg,pieFS4.bmp,Taymar just bought an expensive sports car,1,resources,160167,162918,2751,p,0
220043,9,5,2,18,20,m,Ricky.jpg,pieFS5.bmp,Ricky is saving for his son's operation,2,na,175150,179318,4168,q,1
220043,10,5,2,18,20,m,Joe.jpg,pieFS5.bmp,Joe bullies his employees to put in extra hours at work.,1,reputation,191532,193359,1827,p,0
220043,11,3,2,4,6,f,Deborah.jpg,pieFS3.bmp,Deborah just lost her small business after a franchise moved in next door.,2,na,205566,208979,3413,q,1
220043,12,4,4,16,20,f,Maria.jpg,pieFS4.bmp,Maria used her mother's social security number to open a credit card account.,1,reputation,221199,223519,2320,p,0
220043,13,3,6,14,20,m,Jared.jpg,pieFS3.bmp,Jared just lost his job,2,na,235733,237880,2147,q,1
220043,14,5,2,18,20,m,Sam.jpg,pieFS5.bmp,Sam was mugged and had his wallet stolen.,2,na,250084,252320,2236,q,1
220043,15,3,4,9,13,m,Tony.jpg,pieFS3.bmp,Tony often goes through and steals the neighbors' mail.,1,reputation,264534,267260,2726,p,0
220043,16,4,3,12,15,f,Arianna.jpg,pieFS4.bmp,Arianna is a single mother,2,na,279484,281720,2236,q,1
220043,17,3,2,4,6,f,Emily.jpg,pieFS3.bmp,Emily is raising money to buy gifts for children in need.,2,na,293935,295621,1686,q,1
220043,18,5,1,9,10,f,Jenny.jpg,pieFS5.bmp,Jenny illegally parks in the disabled parking spots when she can.,1,reputation,307836,309881,2045,p,0
220043,19,4,2,8,10,m,Edward.jpg,pieFS4.bmp,Edward employs illegal immigrants and pays them less than minimum wage.,1,reputation,322104,324581,2477,p,0
220043,20,2,3,4,7,m,Paul.jpg,pieFS2.bmp,Paul could not afford his mortgage and his home was foreclosed.,2,na,336804,339141,2337,q,1
220043,21,5,1,9,10,f,Monica.jpg,pieFS5.bmp,Monica's car with her bag and credit cards was recently stolen.,2,na,351354,353402,2048,q,1
220043,22,1,10,10,20,f,Lauren.jpg,pieFS1.bmp,Lauren just found out that her husband has incurred a large credit card debt.,2,na,365622,369342,3720,q,1
220043,23,1,5,5,10,f,Jackie.jpg,pieFS1.bmp,Jackie is a highly paid actress,1,resources,381571,383882,2311,q,1
220043,24,3,2,4,6,f,Cindy.jpg,pieFS3.bmp,Cindy has to take an unpaid leave of absence because her mother broke her hip.,2,na,396105,397923,1818,q,1
220043,25,4,4,16,20,m,Michael.jpg,pieFS4.bmp,Michael has been unable to find a job for over a year.,2,na,410156,411743,1587,q,1
220043,26,3,5,11,16,f,Emma.jpg,pieFS3.bmp,Emma just won the lottery,1,resources,423990,427063,3073,q,1
220043,27,4,1,4,5,f,Sharon.jpg,pieFS4.bmp,Sharon cannot afford to send her son to college.,2,na,439274,442963,3689,q,1
220043,28,4,3,12,15,m,Saul.jpg,pieFS4.bmp,Saul lost his house in a fire,2,na,455189,456724,1535,q,1
220043,29,4,4,16,20,f,Beth.jpg,pieFS4.bmp,Beth regularly fires employees to avoid promoting them.,1,reputation,468924,471464,2540,p,0
220043,30,3,3,7,10,f,Fay.jpg,pieFS3.bmp,Fay secretly gambles with her husband's savings.,1,reputation,483691,486444,2753,p,0
220043,31,5,1,9,10,m,Daniel.jpg,pieFS5.bmp,Daniel is hiding his taxable income in Switzerland.,1,reputation,498658,500744,2086,p,0
220043,32,5,1,9,10,f,Marny.jpg,pieFS5.bmp,Marny got a large cash bonus from her boss,1,resources,512975,515685,2710,p,0
220043,33,4,3,12,15,m,Matt.jpg,pieFS4.bmp,Matt just found $50 on the street,1,resources,527892,532665,4773,q,1
220043,34,3,6,14,20,m,Nick.jpg,pieFS3.bmp,Nick is homeless,2,na,544890,547345,2455,q,1
220043,35,2,7,10,17,f,Sammy.jpg,pieFS2.bmp,Sammy was a victim of identity theft and is now thousands of dollars in debt.,2,na,559573,561665,2092,q,1
220043,36,5,1,9,10,f,Louise.jpg,pieFS5.bmp,Louise claims false expenses for her reportable work travel.,1,reputation,573874,576106,2232,p,0
220043,37,4,2,8,10,f,Kelly.jpg,pieFS4.bmp,Kelly works two waitressing jobs to pay her bills.,2,na,588308,590326,2018,q,1
220043,38,5,1,9,10,f,Trish.jpg,pieFS5.bmp,Trish works as a cleaner in a hotel,2,na,602559,604166,1607,q,1
220043,39,2,6,9,15,m,Darnell.jpg,pieFS2.bmp,Darnell is saving to pay his university fees,2,na,616394,618187,1793,q,1
220043,40,5,2,18,20,m,Ben.jpg,pieFS5.bmp,Ben lives in a luxury penthouse apartment,1,resources,630411,633447,3036,p,0
220043,41,3,4,9,13,m,Don.jpg,pieFS3.bmp,Don stole money from his mother's wallet.,1,reputation,645661,648547,2886,p,0
220043,42,2,6,9,15,m,George.jpg,pieFS2.bmp,George underreports his company's earnings and pockets the profits.,1,reputation,660761,666707,5946,p,0
220043,43,4,1,4,5,m,Peter.jpg,pieFS4.bmp,Peter lost his life savings when his small business failed,2,na,678924,680188,1264,q,1
220043,44,3,3,7,10,m,Alan.jpg,pieFS3.bmp,Alan is a well paid lawyer,1,resources,692393,695968,3575,p,0
220043,45,3,2,4,6,f,Joanna.jpg,pieFS3.bmp,Joanna just received a huge cash settlement,1,resources,708175,710888,2713,q,1
220043,46,1,8,8,16,m,Justin.jpg,pieFS1.bmp,Justin is a retiree,2,na,723125,724908,1783,q,1
220043,47,3,3,7,10,f,Jean.jpg,pieFS3.bmp,Jean takes discarded food from grocery stores to feed her children.,2,na,737126,739229,2103,q,1
220043,48,1,9,9,18,m,Kevin.jpg,pieFS1.bmp,Kevin cheated on his taxes and is now under investigation for tax fraud.,1,reputation,751477,754129,2652,q,1
220043,49,3,5,11,16,m,Jack.jpg,pieFS3.bmp,Jack is a veteran having trouble finding employment.,2,na,766344,769429,3085,q,1
220043,50,3,4,9,13,m,Stuart.jpg,pieFS3.bmp,Stuart stole his elderly father's prescription medications.,1,reputation,781660,784790,3130,p,0
220043,51,2,3,4,7,f,Fiona.jpg,pieFS2.bmp,Fiona's husband is a wealthy investment banker,1,resources,796993,799590,2597,q,1
220043,52,4,3,12,15,f,Eileen.jpg,pieFS4.bmp,Eileen steals her coworkers' tips to buy alcohol.,1,reputation,811793,814050,2257,p,0
220104,1,1,10,10,20,f,Arianna.jpg,pieFS1.bmp,Arianna is going to be evicted because she is behind on her rent,2,na,56685,59861,3176,q,1
220104,2,2,3,4,7,f,Janet.jpg,pieFS2.bmp,Janet owns an international company,1,resources,72051,73962,1911,q,1
220104,3,3,3,7,10,f,Marny.jpg,pieFS3.bmp,Marny just found out that her husband has incurred a large credit card debt.,2,na,86136,87922,1786,q,1
220104,4,4,1,4,5,m,Michael.jpg,pieFS4.bmp,Michael cheated on his taxes and is now under investigation for tax fraud.,1,reputation,100121,102062,1941,q,1
220104,5,3,5,11,16,f,Louise.jpg,pieFS3.bmp,Louise received a large inheritance from a distant relative,1,resources,114255,115683,1428,q,1
220104,6,4,4,16,20,f,Kelly.jpg,pieFS4.bmp,Kelly is a highly paid actress,1,resources,127840,129563,1723,q,1
220104,7,5,1,9,10,m,Taymar.jpg,pieFS5.bmp,Taymar is saving for his son's operation,2,na,141758,143083,1325,q,1
220104,8,5,2,18,20,m,Joe.jpg,pieFS5.bmp,Joe bullies his employees to put in extra hours at work.,1,reputation,155260,157024,1764,q,1
220104,9,2,3,4,7,m,Matt.jpg,pieFS2.bmp,Matt is a veteran having trouble finding employment.,2,na,169178,171224,2046,q,1
220104,10,3,6,14,20,m,Ricky.jpg,pieFS3.bmp,Ricky just lost his job,2,na,183379,184764,1385,q,1
220104,11,3,2,4,6,f,Maria.jpg,pieFS3.bmp,Maria has to take an unpaid leave of absence because her mother broke her hip.,2,na,196947,198065,1118,q,1
220104,12,1,9,9,18,m,Don.jpg,pieFS1.bmp,Don stole his elderly father's prescription medications.,1,reputation,210216,211845,1629,q,1
220104,13,5,2,18,20,m,Ian.jpg,pieFS5.bmp,Ian declared bankruptcy after he was laid off.,2,na,224001,225705,1704,q,1
220104,14,3,2,4,6,f,Trish.jpg,pieFS3.bmp,Trish is a single mother,2,na,237852,239986,2134,q,1
220104,15,3,2,4,6,f,Miriam.jpg,pieFS3.bmp,Miriam just won the lottery,1,resources,252136,254146,2010,q,1
220104,16,3,3,7,10,m,Kevin.jpg,pieFS3.bmp,Kevin takes valuables from his friends' homes when asked to house-sit.,1,reputation,266321,268507,2186,q,1
220104,17,4,3,12,15,f,Kay.jpg,pieFS4.bmp,Kay cannot afford to send her son to college.,2,na,280672,282967,2295,q,1
220104,18,3,3,7,10,f,Lauren.jpg,pieFS3.bmp,Lauren got a large cash bonus from her boss,1,resources,295122,296507,1385,q,1
220104,19,5,1,9,10,f,Fiona.jpg,pieFS5.bmp,Fiona regularly fires employees to avoid promoting them.,1,reputation,308674,311308,2634,q,1
220104,20,4,1,4,5,m,Ben.jpg,pieFS4.bmp,Ben was injured in a hit-and-run accident and cannot afford his medical bills.,2,na,323474,324988,1514,q,1
220104,21,3,5,11,16,m,Stuart.jpg,pieFS3.bmp,Stuart was mugged and had his wallet stolen.,2,na,337143,338768,1625,q,1
220104,22,5,1,9,10,f,Beth.jpg,pieFS5.bmp,Beth secretly gambles with her husband's savings.,1,reputation,350927,353349,2422,q,1
220104,23,3,4,9,13,m,Brad.jpg,pieFS3.bmp,Brad often goes through and steals the neighbors' mail.,1,reputation,365495,367169,1674,q,1
220104,24,5,2,18,20,m,Darnell.jpg,pieFS5.bmp,Darnell has been unable to find a job for over a year.,2,na,379329,380809,1480,q,1
220104,25,5,1,9,10,f,Jackie.jpg,pieFS5.bmp,Jackie was a victim of identity theft and is now thousands of dollars in debt.,2,na,392981,394810,1829,q,1
220104,26,5,1,9,10,m,Jared.jpg,pieFS5.bmp,Jared employs illegal immigrants and pays them less than minimum wage.,1,reputation,406982,409490,2508,q,1
220104,27,4,1,4,5,f,Deborah.jpg,pieFS4.bmp,Deborah works two waitressing jobs to pay her bills.,2,na,421650,423271,1621,q,1
220104,28,5,1,9,10,m,Paul.jpg,pieFS5.bmp,Paul could not afford his mortgage and his home was foreclosed.,2,na,435418,436951,1533,q,1
220104,29,3,6,14,20,m,Jack.jpg,pieFS3.bmp,Jack lost his house in a fire,2,na,449103,450531,1428,q,1
220104,30,4,3,12,15,m,Daniel.jpg,pieFS4.bmp,Daniel is hiding his taxable income in Switzerland.,1,reputation,462704,463912,1208,q,1
220104,31,3,4,9,13,m,Mark.jpg,pieFS3.bmp,Mark just found $50 on the street,1,resources,476073,477432,1359,q,1
220104,32,3,4,9,13,m,George.jpg,pieFS3.bmp,George underreports his company's earnings and pockets the profits.,1,reputation,489608,491053,1445,q,1
220104,33,5,1,9,10,f,Jenny.jpg,pieFS5.bmp,Jenny just received a huge cash settlement,1,resources,503210,505053,1843,q,1
220104,34,5,1,9,10,f,Eileen.jpg,pieFS5.bmp,Eileen takes discarded food from grocery stores to feed her children.,2,na,517211,518693,1482,q,1
220104,35,5,2,18,20,f,Cindy.jpg,pieFS5.bmp,Cindy steals her coworkers' tips to buy alcohol.,1,reputation,530846,532434,1588,q,1
220104,36,5,1,9,10,f,Sammy.jpg,pieFS5.bmp,Sammy just lost her small business after a franchise moved in next door.,2,na,544581,545874,1293,q,1
220104,37,1,5,5,10,f,Monica.jpg,pieFS1.bmp,Monica used her mother's social security number to open a credit card account.,1,reputation,558049,560194,2145,q,1
220104,38,4,2,8,10,f,Emily.jpg,pieFS4.bmp,Emily is raising money to buy gifts for children in need.,2,na,572383,573855,1472,q,1
220104,39,2,6,9,15,m,Alan.jpg,pieFS2.bmp,Alan is a well paid lawyer,1,resources,586052,587875,1823,q,1
220104,40,2,8,12,20,f,Jean.jpg,pieFS2.bmp,Jean illegally parks in the disabled parking spots when she can.,1,reputation,600070,601115,1045,q,1
220104,41,2,6,9,15,m,Peter.jpg,pieFS2.bmp,Peter is homeless,2,na,613288,614496,1208,q,1
220104,42,4,4,16,20,f,Fay.jpg,pieFS4.bmp,Fay claims false expenses for her reportable work travel.,1,reputation,626657,629996,3339,q,1
220104,43,2,7,10,17,f,Joanna.jpg,pieFS2.bmp,Joanna's car with her bag and credit cards was recently stolen.,2,na,642157,643696,1539,q,1
220104,44,4,2,8,10,f,Emma.jpg,pieFS4.bmp,Emma works as a cleaner in a hotel,2,na,655858,657377,1519,q,1
220104,45,1,8,8,16,m,Sam.jpg,pieFS1.bmp,Sam is saving to pay his university fees,2,na,669543,671137,1594,q,1
220104,46,4,4,16,20,m,Edward.jpg,pieFS4.bmp,Edward is a retiree,2,na,683328,685158,1830,q,1
220104,47,4,2,8,10,m,Nick.jpg,pieFS4.bmp,Nick lives in a luxury penthouse apartment,1,resources,697312,699058,1746,q,1
220104,48,4,3,12,15,f,Sharon.jpg,pieFS4.bmp,Sharon's husband is a wealthy investment banker,1,resources,711214,712558,1344,q,1
220104,49,5,2,18,20,m,Justin.jpg,pieFS5.bmp,Justin just bought an expensive sports car,1,resources,724716,726179,1463,q,1
220104,50,4,2,8,10,m,Saul.jpg,pieFS4.bmp,Saul stole money from his mother's wallet.,1,reputation,738350,740019,1669,q,1
220104,51,4,3,12,15,m,Tony.jpg,pieFS4.bmp,Tony lost his life savings when his small business failed,2,na,752169,753479,1310,q,1
220104,52,3,2,4,6,f,Mary.jpg,pieFS3.bmp,Mary can't afford to pay her medical bills,2,na,765637,766960,1323,q,1
220105,1,4,3,12,15,f,Mary.jpg,pieFS4.bmp,Mary owns an international company,1,resources,153673,157383,3710,m,0
220105,2,3,3,7,10,m,Daniel.jpg,pieFS3.bmp,Daniel bullies his employees to put in extra hours at work.,1,reputation,169541,172462,2921,m,0
220105,3,2,3,4,7,m,Don.jpg,pieFS2.bmp,Don is a veteran having trouble finding employment.,2,na,184657,190682,6025,z,1
220105,4,5,2,18,20,m,Mark.jpg,pieFS5.bmp,Mark stole his elderly father's prescription medications.,1,reputation,202900,206230,3330,m,0
220105,5,4,4,16,20,f,Jackie.jpg,pieFS4.bmp,Jackie is a highly paid actress,1,resources,218417,223480,5063,m,0
220105,6,4,4,16,20,m,Paul.jpg,pieFS4.bmp,Paul just lost his job,2,na,235672,243403,7731,z,1
220105,7,4,3,12,15,m,Joe.jpg,pieFS4.bmp,Joe employs illegal immigrants and pays them less than minimum wage.,1,reputation,255604,260045,4441,m,0
220105,8,5,1,9,10,f,Joanna.jpg,pieFS5.bmp,Joanna has to take an unpaid leave of absence because her mother broke her hip.,2,na,272241,275952,3711,m,0
220105,9,4,4,16,20,f,Marny.jpg,pieFS4.bmp,Marny got a large cash bonus from her boss,1,resources,288143,292249,4106,m,0
220105,10,5,1,9,10,f,Jenny.jpg,pieFS5.bmp,Jenny was a victim of identity theft and is now thousands of dollars in debt.,2,na,304445,309500,5055,m,0
220105,11,3,2,4,6,f,Monica.jpg,pieFS3.bmp,Monica works two waitressing jobs to pay her bills.,2,na,321668,324444,2776,z,1
220105,12,1,5,5,10,f,Beth.jpg,pieFS1.bmp,Beth received a large inheritance from a distant relative,1,resources,336633,340283,3650,m,0
220105,13,4,3,12,15,m,Darnell.jpg,pieFS4.bmp,Darnell declared bankruptcy after he was laid off.,2,na,352484,358846,6362,m,0
220105,14,4,2,8,10,m,Tony.jpg,pieFS4.bmp,Tony takes valuables from his friends' homes when asked to house-sit.,1,reputation,371061,373675,2614,m,0
220105,15,5,2,18,20,m,Michael.jpg,pieFS5.bmp,Michael was injured in a hit-and-run accident and cannot afford his medical bills.,2,na,385843,388361,2518,z,1
220105,16,5,1,9,10,f,Kay.jpg,pieFS5.bmp,Kay is a single mother,2,na,400524,403489,2965,m,0
220105,17,1,8,8,16,m,Edward.jpg,pieFS1.bmp,Edward could not afford his mortgage and his home was foreclosed.,2,na,415656,418881,3225,m,0
220105,18,5,1,9,10,f,Emily.jpg,pieFS5.bmp,Emily just received a huge cash settlement,1,resources,431056,433006,1950,m,0
220105,19,5,1,9,10,f,Miriam.jpg,pieFS5.bmp,Miriam just won the lottery,1,resources,445185,447384,2199,m,0
220105,20,5,1,9,10,m,Alan.jpg,pieFS5.bmp,Alan is hiding his taxable income in Switzerland.,1,reputation,459582,461711,2129,m,0
220105,21,2,7,10,17,f,Maria.jpg,pieFS2.bmp,Maria takes discarded food from grocery stores to feed her children.,2,na,473911,477634,3723,z,1
220105,22,2,6,9,15,m,Brad.jpg,pieFS2.bmp,Brad was mugged and had his wallet stolen.,2,na,489830,495166,5336,m,0
220105,23,5,2,18,20,m,Justin.jpg,pieFS5.bmp,Justin underreports his company's earnings and pockets the profits.,1,reputation,507320,509744,2424,m,0
220105,24,3,3,7,10,f,Sharon.jpg,pieFS3.bmp,Sharon cannot afford to send her son to college.,2,na,521934,525230,3296,m,0
220105,25,3,2,4,6,f,Eileen.jpg,pieFS3.bmp,Eileen steals her coworkers' tips to buy alcohol.,1,reputation,537401,541403,4002,m,0
220105,26,4,1,4,5,m,Jared.jpg,pieFS4.bmp,Jared is a well paid lawyer,1,resources,553603,556403,2800,m,0
220105,27,5,1,9,10,f,Fiona.jpg,pieFS5.bmp,Fiona regularly fires employees to avoid promoting them.,1,reputation,568618,571336,2718,m,0
220105,28,5,1,9,10,m,George.jpg,pieFS5.bmp,George is a retiree,2,na,583533,586717,3184,m,0
220105,29,4,2,8,10,f,Jean.jpg,pieFS4.bmp,Jean just lost her small business after a franchise moved in next door.,2,na,598917,605968,7051,z,1
220105,30,2,8,12,20,f,Deborah.jpg,pieFS2.bmp,Deborah used her mother's social security number to open a credit card account.,1,reputation,618162,625971,7809,m,0
220105,31,3,4,9,13,m,Nick.jpg,pieFS3.bmp,Nick often goes through and steals the neighbors' mail.,1,reputation,638161,641267,3106,m,0
220105,32,3,6,14,20,m,Stuart.jpg,pieFS3.bmp,Stuart has been unable to find a job for over a year.,2,na,653460,657862,4402,m,0
220105,33,4,3,12,15,f,Cindy.jpg,pieFS4.bmp,Cindy is raising money to buy gifts for children in need.,2,na,670047,672207,2160,m,0
220105,34,5,2,18,20,f,Fay.jpg,pieFS5.bmp,Fay secretly gambles with her husband's savings.,1,reputation,684410,687000,2590,m,0
220105,35,5,2,18,20,m,Ian.jpg,pieFS5.bmp,Ian lost his house in a fire,2,na,699192,701457,2265,m,0
220105,36,3,3,7,10,f,Emma.jpg,pieFS3.bmp,Emma claims false expenses for her reportable work travel.,1,reputation,713588,716552,2964,m,0
220105,37,3,5,11,16,f,Sammy.jpg,pieFS3.bmp,Sammy illegally parks in the disabled parking spots when she can.,1,reputation,728754,731959,3205,z,1
220105,38,4,2,8,10,m,Jack.jpg,pieFS4.bmp,Jack just found $50 on the street,1,resources,744137,746604,2467,m,0
220105,39,1,10,10,20,f,Arianna.jpg,pieFS1.bmp,Arianna works as a cleaner in a hotel,2,na,758785,763320,4535,z,1
220105,40,2,3,4,7,f,Trish.jpg,pieFS2.bmp,Trish's husband is a wealthy investment banker,1,resources,775522,778508,2986,z,1
220105,41,3,2,4,6,f,Lauren.jpg,pieFS3.bmp,Lauren's car with her bag and credit cards was recently stolen.,2,na,790688,792994,2306,z,1
220105,42,1,9,9,18,m,Taymar.jpg,pieFS1.bmp,Taymar just bought an expensive sports car,1,resources,805152,807615,2463,z,1
220105,43,4,1,4,5,m,Ben.jpg,pieFS4.bmp,Ben is homeless,2,na,819799,822546,2747,m,0
220105,44,3,2,4,6,f,Louise.jpg,pieFS3.bmp,Louise can't afford to pay her medical bills,2,na,834748,837703,2955,z,1
220105,45,3,5,11,16,m,Sam.jpg,pieFS3.bmp,Sam is saving to pay his university fees,2,na,849897,852782,2885,z,1
220105,46,3,4,9,13,m,Kevin.jpg,pieFS3.bmp,Kevin lives in a luxury penthouse apartment,1,resources,864979,867500,2521,m,0
220105,47,2,6,9,15,m,Saul.jpg,pieFS2.bmp,Saul stole money from his mother's wallet.,1,reputation,879660,887425,7765,z,1
220105,48,3,6,14,20,m,Matt.jpg,pieFS3.bmp,Matt lost his life savings when his small business failed,2,na,899625,904394,4769,m,0
220105,49,3,4,9,13,m,Peter.jpg,pieFS3.bmp,Peter cheated on his taxes and is now under investigation for tax fraud.,1,reputation,916580,921473,4893,m,0
220105,50,4,2,8,10,f,Kelly.jpg,pieFS4.bmp,Kelly just found out that her husband has incurred a large credit card debt.,2,na,933635,937787,4152,m,0
220105,51,4,1,4,5,f,Janet.jpg,pieFS4.bmp,Janet is going to be evicted because she is behind on her rent,2,na,949971,952475,2504,m,0
220105,52,5,1,9,10,m,Ricky.jpg,pieFS5.bmp,Ricky is saving for his son's operation,2,na,964669,967538,2869,m,0
220130,1,4,4,16,20,f,Sharon.jpg,pieFS4.bmp,Sharon received a large inheritance from a distant relative,1,resources,70678,75277,4599,q,1
220130,2,4,4,16,20,f,Kelly.jpg,pieFS4.bmp,Kelly illegally parks in the disabled parking spots when she can.,1,reputation,87576,90497,2921,p,0
220130,3,3,4,9,13,m,Justin.jpg,pieFS3.bmp,Justin underreports his company's earnings and pockets the profits.,1,reputation,102792,108058,5266,p,0
220130,4,1,10,10,20,f,Kay.jpg,pieFS1.bmp,Kay is a single mother,2,na,120323,123098,2775,q,1
220130,5,3,3,7,10,f,Deborah.jpg,pieFS3.bmp,Deborah's car with her bag and credit cards was recently stolen.,2,na,135390,140399,5009,q,1
220130,6,4,1,4,5,m,Saul.jpg,pieFS4.bmp,Saul just found $50 on the street,1,resources,152687,158019,5332,q,1
220130,7,4,2,8,10,f,Jenny.jpg,pieFS4.bmp,Jenny just found out that her husband has incurred a large credit card debt.,2,na,170318,173319,3001,p,0
220130,8,5,1,9,10,m,Stuart.jpg,pieFS5.bmp,Stuart is homeless,2,na,185618,190540,4922,q,1
220130,9,4,2,8,10,m,Taymar.jpg,pieFS4.bmp,Taymar is a well paid lawyer,1,resources,202832,206340,3508,p,0
220130,10,1,8,8,16,m,Matt.jpg,pieFS1.bmp,Matt is saving to pay his university fees,2,na,218631,221421,2790,q,1
220130,11,3,3,7,10,f,Monica.jpg,pieFS3.bmp,Monica is a highly paid actress,1,resources,233715,236721,3006,q,1
220130,12,3,2,4,6,f,Marny.jpg,pieFS3.bmp,Marny has to take an unpaid leave of absence because her mother broke her hip.,2,na,249015,252622,3607,q,1
220130,13,3,2,4,6,f,Maria.jpg,pieFS3.bmp,Maria got a large cash bonus from her boss,1,resources,264914,270622,5708,q,1
220130,14,5,1,9,10,m,George.jpg,pieFS5.bmp,George is a retiree,2,na,282911,287143,4232,p,0
220130,15,3,4,9,13,m,Kevin.jpg,pieFS3.bmp,Kevin lives in a luxury penthouse apartment,1,resources,299692,300943,1251,q,1
220130,16,5,2,18,20,m,Sam.jpg,pieFS5.bmp,Sam stole money from his mother's wallet.,1,reputation,313211,313703,492,p,0
220130,17,3,3,7,10,m,Daniel.jpg,pieFS3.bmp,Daniel just bought an expensive sports car,1,resources,325963,326784,821,q,1
220130,18,4,1,4,5,m,Brad.jpg,pieFS4.bmp,Brad lost his life savings when his small business failed,2,na,339032,341084,2052,q,1
220130,19,5,2,18,20,m,Tony.jpg,pieFS5.bmp,Tony cheated on his taxes and is now under investigation for tax fraud.,1,reputation,353366,354804,1438,p,0
220130,20,5,1,9,10,f,Eileen.jpg,pieFS5.bmp,Eileen was a victim of identity theft and is now thousands of dollars in debt.,2,na,367101,367885,784,q,1
220130,21,4,4,16,20,m,Don.jpg,pieFS4.bmp,Don is a veteran having trouble finding employment.,2,na,380170,382405,2235,q,1
220130,22,1,5,5,10,f,Louise.jpg,pieFS1.bmp,Louise just won the lottery,1,resources,394671,398146,3475,q,1
220130,23,5,2,18,20,m,Joe.jpg,pieFS5.bmp,Joe is saving for his son's operation,2,na,410420,414186,3766,q,1
220130,24,4,3,12,15,m,Mark.jpg,pieFS4.bmp,Mark stole his elderly father's prescription medications.,1,reputation,426419,428787,2368,q,1
220130,25,4,1,4,5,f,Miriam.jpg,pieFS4.bmp,Miriam cannot afford to send her son to college.,2,na,441053,443147,2094,q,1
220130,26,5,2,18,20,f,Arianna.jpg,pieFS5.bmp,Arianna regularly fires employees to avoid promoting them.,1,reputation,455420,460567,5147,p,0
220130,27,5,1,9,10,f,Fay.jpg,pieFS5.bmp,Fay secretly gambles with her husband's savings.,1,reputation,472818,474828,2010,p,0
220130,28,3,5,11,16,f,Mary.jpg,pieFS3.bmp,Mary claims false expenses for her reportable work travel.,1,reputation,487052,492088,5036,p,0
220130,29,4,2,8,10,f,Fiona.jpg,pieFS4.bmp,Fiona works as a cleaner in a hotel,2,na,504317,506948,2631,q,1
220130,30,5,1,9,10,f,Jackie.jpg,pieFS5.bmp,Jackie works two waitressing jobs to pay her bills.,2,na,519183,521449,2266,q,1
220130,31,4,3,12,15,f,Jean.jpg,pieFS4.bmp,Jean just received a huge cash settlement,1,resources,533684,535709,2025,q,1
220130,32,2,6,9,15,m,Alan.jpg,pieFS2.bmp,Alan bullies his employees to put in extra hours at work.,1,reputation,547985,551310,3325,p,0
220130,33,4,3,12,15,m,Jack.jpg,pieFS4.bmp,Jack declared bankruptcy after he was laid off.,2,na,563568,565350,1782,q,1
220130,34,2,7,10,17,f,Joanna.jpg,pieFS2.bmp,Joanna takes discarded food from grocery stores to feed her children.,2,na,577602,579970,2368,q,1
220130,35,5,1,9,10,m,Peter.jpg,pieFS5.bmp,Peter takes valuables from his friends' homes when asked to house-sit.,1,reputation,592220,594731,2511,p,0
220130,36,3,6,14,20,m,Paul.jpg,pieFS3.bmp,Paul just lost his job,2,na,606953,610351,3398,q,1
220130,37,5,2,18,20,m,Michael.jpg,pieFS5.bmp,Michael was injured in a hit-and-run accident and cannot afford his medical bills.,2,na,622603,624871,2268,q,1
220130,38,5,1,9,10,f,Lauren.jpg,pieFS5.bmp,Lauren steals her coworkers' tips to buy alcohol.,1,reputation,637104,639192,2088,p,0
220130,39,2,6,9,15,m,Darnell.jpg,pieFS2.bmp,Darnell was mugged and had his wallet stolen.,2,na,651421,654212,2791,q,1
220130,40,3,2,4,6,f,Sammy.jpg,pieFS3.bmp,Sammy just lost her small business after a franchise moved in next door.,2,na,666454,670613,4159,q,1
220130,41,1,9,9,18,m,Jared.jpg,pieFS1.bmp,Jared employs illegal immigrants and pays them less than minimum wage.,1,reputation,682836,684933,2097,p,0
220130,42,3,4,9,13,m,Ian.jpg,pieFS3.bmp,Ian often goes through and steals the neighbors' mail.,1,reputation,697171,699294,2123,p,0
220130,43,2,3,4,7,f,Emma.jpg,pieFS2.bmp,Emma's husband is a wealthy investment banker,1,resources,711521,713494,1973,q,1
220130,44,2,8,12,20,f,Emily.jpg,pieFS2.bmp,Emily used her mother's social security number to open a credit card account.,1,reputation,725722,726494,772,p,0
220130,45,3,6,14,20,m,Ben.jpg,pieFS3.bmp,Ben has been unable to find a job for over a year.,2,na,738741,739575,834,q,1
220130,46,3,5,11,16,m,Edward.jpg,pieFS3.bmp,Edward could not afford his mortgage and his home was foreclosed.,2,na,751794,752635,841,q,1
220130,47,5,1,9,10,f,Trish.jpg,pieFS5.bmp,Trish can't afford to pay her medical bills,2,na,764879,768176,3297,q,1
220130,48,4,2,8,10,m,Ricky.jpg,pieFS4.bmp,Ricky is hiding his taxable income in Switzerland.,1,reputation,780396,782956,2560,p,0
220130,49,3,2,4,6,f,Cindy.jpg,pieFS3.bmp,Cindy is raising money to buy gifts for children in need.,2,na,795179,796876,1697,q,1
220130,50,4,3,12,15,f,Janet.jpg,pieFS4.bmp,Janet is going to be evicted because she is behind on her rent,2,na,809097,810977,1880,q,1
220130,51,2,3,4,7,m,Nick.jpg,pieFS2.bmp,Nick lost his house in a fire,2,na,823198,825777,2579,q,1
220130,52,5,1,9,10,f,Beth.jpg,pieFS5.bmp,Beth owns an international company,1,resources,838015,840077,2062,q,1
220152,1,3,3,7,10,f,Arianna.jpg,pieFS3.bmp,Arianna is going to be evicted because she is behind on her rent,2,na,99256,102465,3209,q,1
220152,2,5,2,18,20,m,Saul.jpg,pieFS5.bmp,Saul cheated on his taxes and is now under investigation for tax fraud.,1,reputation,114656,116557,1901,p,0
220152,3,4,4,16,20,f,Trish.jpg,pieFS4.bmp,Trish owns an international company,1,resources,128751,131230,2479,q,1
220152,4,2,8,12,20,f,Fiona.jpg,pieFS2.bmp,Fiona received a large inheritance from a distant relative,1,resources,143449,144746,1297,q,1
220152,5,4,1,4,5,m,Jack.jpg,pieFS4.bmp,Jack is a veteran having trouble finding employment.,2,na,156943,158244,1301,q,1
220152,6,4,2,8,10,m,Sam.jpg,pieFS4.bmp,Sam stole his elderly father's prescription medications.,1,reputation,170437,171982,1545,p,0
220152,7,3,5,11,16,m,Daniel.jpg,pieFS3.bmp,Daniel is a retiree,2,na,184198,185560,1362,q,1
220152,8,5,1,9,10,f,Deborah.jpg,pieFS5.bmp,Deborah just received a huge cash settlement,1,resources,197758,198890,1132,q,1
220152,9,5,1,9,10,m,Ian.jpg,pieFS5.bmp,Ian declared bankruptcy after he was laid off.,2,na,211085,212562,1477,p,0
220152,10,2,6,9,15,m,Ben.jpg,pieFS2.bmp,Ben takes valuables from his friends' homes when asked to house-sit.,1,reputation,224763,227598,2835,p,0
220152,11,2,6,9,15,m,Nick.jpg,pieFS2.bmp,Nick was injured in a hit-and-run accident and cannot afford his medical bills.,2,na,239761,241879,2118,q,1
220152,12,4,1,4,5,f,Sharon.jpg,pieFS4.bmp,Sharon is a single mother,2,na,254074,255223,1149,q,1
220152,13,5,2,18,20,f,Louise.jpg,pieFS5.bmp,Louise just won the lottery,1,resources,267418,268193,775,q,1
220152,14,5,1,9,10,f,Emily.jpg,pieFS5.bmp,Emily takes discarded food from grocery stores to feed her children.,2,na,280376,281127,751,q,1
220152,15,4,3,12,15,m,Peter.jpg,pieFS4.bmp,Peter was mugged and had his wallet stolen.,2,na,293318,294397,1079,q,1
220152,16,1,5,5,10,f,Marny.jpg,pieFS1.bmp,Marny steals her coworkers' tips to buy alcohol.,1,reputation,306611,307398,787,q,1
220152,17,3,4,9,13,m,Joe.jpg,pieFS3.bmp,Joe just bought an expensive sports car,1,resources,319587,320914,1327,q,1
220152,18,3,2,4,6,f,Maria.jpg,pieFS3.bmp,Maria just lost her small business after a franchise moved in next door.,2,na,333097,333883,786,q,1
220152,19,3,6,14,20,m,Alan.jpg,pieFS3.bmp,Alan is saving for his son's operation,2,na,346073,346844,771,q,1
220152,20,4,2,8,10,f,Fay.jpg,pieFS4.bmp,Fay cannot afford to send her son to college.,2,na,359048,360135,1087,q,1
220152,21,5,1,9,10,f,Kay.jpg,pieFS5.bmp,Kay regularly fires employees to avoid promoting them.,1,reputation,372341,373479,1138,p,0
220152,22,5,1,9,10,m,Ricky.jpg,pieFS5.bmp,Ricky bullies his employees to put in extra hours at work.,1,reputation,385668,387137,1469,p,0
220152,23,4,3,12,15,f,Jean.jpg,pieFS4.bmp,Jean used her mother's social security number to open a credit card account.,1,reputation,399329,401873,2544,q,1
220152,24,4,2,8,10,f,Sammy.jpg,pieFS4.bmp,Sammy is raising money to buy gifts for children in need.,2,na,414077,415029,952,q,1
220152,25,3,5,11,16,f,Monica.jpg,pieFS3.bmp,Monica illegally parks in the disabled parking spots when she can.,1,reputation,427236,428999,1763,q,1
220152,26,5,2,18,20,m,Edward.jpg,pieFS5.bmp,Edward just lost his job,2,na,441198,442156,958,q,1
220152,27,5,1,9,10,f,Janet.jpg,pieFS5.bmp,Janet secretly gambles with her husband's savings.,1,reputation,454340,455938,1598,p,0
220152,28,3,3,7,10,f,Mary.jpg,pieFS3.bmp,Mary claims false expenses for her reportable work travel.,1,reputation,468135,469329,1194,q,1
220152,29,4,1,4,5,m,Stuart.jpg,pieFS4.bmp,Stuart often goes through and steals the neighbors' mail.,1,reputation,481545,483033,1488,p,0
220152,30,3,6,14,20,m,Michael.jpg,pieFS3.bmp,Michael has been unable to find a job for over a year.,2,na,495223,496471,1248,q,1
220152,31,3,4,9,13,m,Jared.jpg,pieFS3.bmp,Jared employs illegal immigrants and pays them less than minimum wage.,1,reputation,508667,510316,1649,q,1
220152,32,2,7,10,17,f,Emma.jpg,pieFS2.bmp,Emma works as a cleaner in a hotel,2,na,522512,523593,1081,q,1
220152,33,3,2,4,6,f,Joanna.jpg,pieFS3.bmp,Joanna's car with her bag and credit cards was recently stolen.,2,na,535788,536739,951,q,1
220152,34,4,3,12,15,f,Lauren.jpg,pieFS4.bmp,Lauren just found out that her husband has incurred a large credit card debt.,2,na,548931,550083,1152,q,1
220152,35,4,4,16,20,f,Jenny.jpg,pieFS4.bmp,Jenny is a highly paid actress,1,resources,562274,563724,1450,q,1
220152,36,1,8,8,16,m,Kevin.jpg,pieFS1.bmp,Kevin lost his house in a fire,2,na,575918,577147,1229,q,1
220152,37,1,9,9,18,m,Mark.jpg,pieFS1.bmp,Mark just found $50 on the street,1,resources,589345,590445,1100,q,1
220152,38,2,3,4,7,f,Miriam.jpg,pieFS2.bmp,Miriam's husband is a wealthy investment banker,1,resources,602638,603930,1292,q,1
220152,39,5,1,9,10,f,Eileen.jpg,pieFS5.bmp,Eileen has to take an unpaid leave of absence because her mother broke her hip.,2,na,616098,617951,1853,q,1
220152,40,5,1,9,10,m,Justin.jpg,pieFS5.bmp,Justin could not afford his mortgage and his home was foreclosed.,2,na,630144,631702,1558,q,1
220152,41,3,2,4,6,f,Jackie.jpg,pieFS3.bmp,Jackie got a large cash bonus from her boss,1,resources,643905,645089,1184,q,1
220152,42,4,2,8,10,m,Taymar.jpg,pieFS4.bmp,Taymar is hiding his taxable income in Switzerland.,1,reputation,657282,658813,1531,q,1
220152,43,5,1,9,10,f,Cindy.jpg,pieFS5.bmp,Cindy was a victim of identity theft and is now thousands of dollars in debt.,2,na,671010,672501,1491,q,1
220152,44,4,4,16,20,m,Matt.jpg,pieFS4.bmp,Matt is homeless,2,na,684687,687002,2315,q,1
220152,45,3,3,7,10,m,George.jpg,pieFS3.bmp,George underreports his company's earnings and pockets the profits.,1,reputation,699184,701412,2228,p,0
220152,46,1,10,10,20,f,Beth.jpg,pieFS1.bmp,Beth can't afford to pay her medical bills,2,na,713615,716113,2498,q,1
220152,47,3,2,4,6,f,Kelly.jpg,pieFS3.bmp,Kelly works two waitressing jobs to pay her bills.,2,na,728296,729801,1505,q,1
220152,48,5,2,18,20,m,Paul.jpg,pieFS5.bmp,Paul is a well paid lawyer,1,resources,741990,746239,4249,q,1
220152,49,2,3,4,7,m,Don.jpg,pieFS2.bmp,Don is saving to pay his university fees,2,na,758410,760322,1912,q,1
220152,50,4,3,12,15,m,Tony.jpg,pieFS4.bmp,Tony lives in a luxury penthouse apartment,1,resources,772522,774319,1797,p,0
220152,51,3,4,9,13,m,Darnell.jpg,pieFS3.bmp,Darnell stole money from his mother's wallet.,1,reputation,786501,788272,1771,q,1
220152,52,5,2,18,20,m,Brad.jpg,pieFS5.bmp,Brad lost his life savings when his small business failed,2,na,800463,801742,1279,q,1
220184,1,5,1,9,10,f,Emma.jpg,pieFS5.bmp,Emma claims false expenses for her reportable work travel.,1,reputation,75906,78629,2723,p,0
220184,2,5,1,9,10,f,Fay.jpg,pieFS5.bmp,Fay works as a cleaner in a hotel,2,na,90922,96369,5447,p,0
220184,3,4,3,12,15,m,Taymar.jpg,pieFS4.bmp,Taymar is saving for his son's operation,2,na,108636,112329,3693,q,1
220184,4,2,6,9,15,m,Daniel.jpg,pieFS2.bmp,Daniel bullies his employees to put in extra hours at work.,1,reputation,124585,131569,6984,p,0
220184,5,4,4,16,20,f,Lauren.jpg,pieFS4.bmp,Lauren used her mother's social security number to open a credit card account.,1,reputation,143847,145410,1563,p,0
220184,6,5,1,9,10,f,Miriam.jpg,pieFS5.bmp,Miriam's husband is a wealthy investment banker,1,resources,157681,159990,2309,p,0
220184,7,5,1,9,10,m,Stuart.jpg,pieFS5.bmp,Stuart cheated on his taxes and is now under investigation for tax fraud.,1,reputation,172231,174090,1859,p,0
220184,8,3,5,11,16,m,Michael.jpg,pieFS3.bmp,Michael is a veteran having trouble finding employment.,2,na,186316,187370,1054,q,1
220184,9,1,10,10,20,f,Eileen.jpg,pieFS1.bmp,Eileen is raising money to buy gifts for children in need.,2,na,199601,202050,2449,q,1
220184,10,4,2,8,10,m,Kevin.jpg,pieFS4.bmp,Kevin stole his elderly father's prescription medications.,1,reputation,214284,216350,2066,p,0
220184,11,2,6,9,15,m,Alan.jpg,pieFS2.bmp,Alan just lost his job,2,na,228569,231591,3022,q,1
220184,12,4,2,8,10,f,Trish.jpg,pieFS4.bmp,Trish can't afford to pay her medical bills,2,na,243801,245751,1950,q,1
220184,13,5,1,9,10,f,Sharon.jpg,pieFS5.bmp,Sharon is going to be evicted because she is behind on her rent,2,na,257969,260271,2302,q,1
220184,14,1,5,5,10,f,Kelly.jpg,pieFS1.bmp,Kelly illegally parks in the disabled parking spots when she can.,1,reputation,272503,277891,5388,p,0
220184,15,3,6,14,20,m,Jack.jpg,pieFS3.bmp,Jack declared bankruptcy after he was laid off.,2,na,290116,291831,1715,q,1
220184,16,4,1,4,5,m,Nick.jpg,pieFS4.bmp,Nick takes valuables from his friends' homes when asked to house-sit.,1,reputation,304051,305372,1321,p,0
220184,17,3,2,4,6,f,Janet.jpg,pieFS3.bmp,Janet owns an international company,1,resources,317602,324872,7270,p,0
220184,18,4,2,8,10,m,George.jpg,pieFS4.bmp,George employs illegal immigrants and pays them less than minimum wage.,1,reputation,337114,337912,798,p,0
220184,19,5,2,18,20,m,Don.jpg,pieFS5.bmp,Don was injured in a hit-and-run accident and cannot afford his medical bills.,2,na,350133,351112,979,q,1
220184,20,4,3,12,15,f,Joanna.jpg,pieFS4.bmp,Joanna's car with her bag and credit cards was recently stolen.,2,na,363335,365212,1877,q,1
220184,21,3,6,14,20,m,Peter.jpg,pieFS3.bmp,Peter was mugged and had his wallet stolen.,2,na,377485,379572,2087,q,1
220184,22,5,1,9,10,f,Mary.jpg,pieFS5.bmp,Mary received a large inheritance from a distant relative,1,resources,391803,393872,2069,p,0
220184,23,3,3,7,10,f,Marny.jpg,pieFS3.bmp,Marny just found out that her husband has incurred a large credit card debt.,2,na,406103,411453,5350,p,0
220184,24,4,4,16,20,m,Edward.jpg,pieFS4.bmp,Edward could not afford his mortgage and his home was foreclosed.,2,na,423667,428213,4546,q,1
220184,25,5,2,18,20,m,Ian.jpg,pieFS5.bmp,Ian often goes through and steals the neighbors' mail.,1,reputation,440465,442513,2048,p,0
220184,26,4,1,4,5,f,Fiona.jpg,pieFS4.bmp,Fiona is a single mother,2,na,454799,459613,4814,q,1
220184,27,2,3,4,7,m,Brad.jpg,pieFS2.bmp,Brad has been unable to find a job for over a year.,2,na,471897,474653,2756,q,1
220184,28,4,1,4,5,m,Ben.jpg,pieFS4.bmp,Ben lost his house in a fire,2,na,486946,489194,2248,q,1
220184,29,3,3,7,10,m,Mark.jpg,pieFS3.bmp,Mark just found $50 on the street,1,resources,501447,508194,6747,q,1
220184,30,5,1,9,10,m,Saul.jpg,pieFS5.bmp,Saul is homeless,2,na,520426,522614,2188,q,1
220184,31,4,3,12,15,m,Justin.jpg,pieFS4.bmp,Justin is hiding his taxable income in Switzerland.,1,reputation,534826,536034,1208,p,0
220184,32,3,5,11,16,f,Jackie.jpg,pieFS3.bmp,Jackie is a highly paid actress,1,resources,548261,554354,6093,q,1
220184,33,4,3,12,15,f,Arianna.jpg,pieFS4.bmp,Arianna just won the lottery,1,resources,566574,568234,1660,q,1
220184,34,2,7,10,17,f,Sammy.jpg,pieFS2.bmp,Sammy has to take an unpaid leave of absence because her mother broke her hip.,2,na,580459,581595,1136,q,1
220184,35,5,1,9,10,m,Darnell.jpg,pieFS5.bmp,Darnell is saving to pay his university fees,2,na,593810,600615,6805,q,1
220184,36,3,4,9,13,m,Joe.jpg,pieFS3.bmp,Joe underreports his company's earnings and pockets the profits.,1,reputation,612839,614155,1316,p,0
220184,37,5,2,18,20,m,Sam.jpg,pieFS5.bmp,Sam lives in a luxury penthouse apartment,1,resources,626391,628855,2464,p,0
220184,38,3,4,9,13,m,Ricky.jpg,pieFS3.bmp,Ricky is a well paid lawyer,1,resources,641091,642935,1844,p,0
220184,39,5,2,18,20,f,Deborah.jpg,pieFS5.bmp,Deborah got a large cash bonus from her boss,1,resources,655158,657495,2337,p,0
220184,40,3,2,4,6,f,Louise.jpg,pieFS3.bmp,Louise cannot afford to send her son to college.,2,na,669725,671595,1870,q,1
220184,41,3,4,9,13,m,Tony.jpg,pieFS3.bmp,Tony stole money from his mother's wallet.,1,reputation,683826,685396,1570,p,0
220184,42,3,2,4,6,f,Maria.jpg,pieFS3.bmp,Maria was a victim of identity theft and is now thousands of dollars in debt.,2,na,697628,699136,1508,q,1
220184,43,5,1,9,10,f,Cindy.jpg,pieFS5.bmp,Cindy works two waitressing jobs to pay her bills.,2,na,711362,712736,1374,q,1
220184,44,2,8,12,20,f,Kay.jpg,pieFS2.bmp,Kay regularly fires employees to avoid promoting them.,1,reputation,724964,726856,1892,p,0
220184,45,4,4,16,20,f,Emily.jpg,pieFS4.bmp,Emily just received a huge cash settlement,1,resources,739081,740756,1675,p,0
220184,46,1,8,8,16,m,Matt.jpg,pieFS1.bmp,Matt lost his life savings when his small business failed,2,na,752982,754917,1935,q,1
220184,47,5,2,18,20,m,Jared.jpg,pieFS5.bmp,Jared is a retiree,2,na,767150,771537,4387,p,0
220184,48,3,2,4,6,f,Jenny.jpg,pieFS3.bmp,Jenny takes discarded food from grocery stores to feed her children.,2,na,783765,785517,1752,q,1
220184,49,3,3,7,10,f,Beth.jpg,pieFS3.bmp,Beth secretly gambles with her husband's savings.,1,reputation,797749,798437,688,p,0
220184,50,2,3,4,7,f,Monica.jpg,pieFS2.bmp,Monica steals her coworkers' tips to buy alcohol.,1,reputation,810668,811657,989,p,0
220184,51,4,2,8,10,f,Jean.jpg,pieFS4.bmp,Jean just lost her small business after a franchise moved in next door.,2,na,823887,828097,4210,q,1
220184,52,1,9,9,18,m,Paul.jpg,pieFS1.bmp,Paul just bought an expensive sports car,1,resources,840318,845098,4780,q,1
220274,1,4,4,16,20,f,Mary.jpg,pieFS4.bmp,Mary received a large inheritance from a distant relative,1,resources,37934,41297,3363,q,1
220274,2,3,2,4,6,f,Arianna.jpg,pieFS3.bmp,Arianna is a single mother,2,na,53500,54938,1438,q,1
220274,3,4,2,8,10,f,Jenny.jpg,pieFS4.bmp,Jenny has to take an unpaid leave of absence because her mother broke her hip.,2,na,67135,68378,1243,q,1
220274,4,3,6,14,20,m,Paul.jpg,pieFS3.bmp,Paul is saving for his son's operation,2,na,80553,81578,1025,q,1
220274,5,4,2,8,10,m,Ian.jpg,pieFS4.bmp,Ian just found $50 on the street,1,resources,93739,94998,1259,q,1
220274,6,5,2,18,20,m,Tony.jpg,pieFS5.bmp,Tony is homeless,2,na,107191,108339,1148,q,1
220274,7,5,2,18,20,m,Joe.jpg,pieFS5.bmp,Joe bullies his employees to put in extra hours at work.,1,reputation,120509,121619,1110,q,1
220274,8,3,6,14,20,m,Mark.jpg,pieFS3.bmp,Mark is saving to pay his university fees,2,na,133811,135199,1388,q,1
220274,9,3,5,11,16,f,Emily.jpg,pieFS3.bmp,Emily got a large cash bonus from her boss,1,resources,147379,148759,1380,q,1
220274,10,5,1,9,10,m,Taymar.jpg,pieFS5.bmp,Taymar just lost his job,2,na,160931,161860,929,q,1
220274,11,5,1,9,10,f,Beth.jpg,pieFS5.bmp,Beth just won the lottery,1,resources,174033,175260,1227,q,1
220274,12,5,1,9,10,f,Monica.jpg,pieFS5.bmp,Monica was a victim of identity theft and is now thousands of dollars in debt.,2,na,187451,188280,829,q,1
220274,13,1,9,9,18,m,Nick.jpg,pieFS1.bmp,Nick lives in a luxury penthouse apartment,1,resources,200454,201460,1006,q,1
220274,14,3,4,9,13,m,Brad.jpg,pieFS3.bmp,Brad stole money from his mother's wallet.,1,reputation,213656,216761,3105,p,0
220274,15,3,2,4,6,f,Deborah.jpg,pieFS3.bmp,Deborah works two waitressing jobs to pay her bills.,2,na,228939,230161,1222,q,1
220274,16,1,8,8,16,m,Matt.jpg,pieFS1.bmp,Matt lost his life savings when his small business failed,2,na,242307,243221,914,q,1
220274,17,3,3,7,10,m,Michael.jpg,pieFS3.bmp,Michael cheated on his taxes and is now under investigation for tax fraud.,1,reputation,255393,258541,3148,p,0
220274,18,1,10,10,20,f,Emma.jpg,pieFS1.bmp,Emma cannot afford to send her son to college.,2,na,270709,271742,1033,q,1
220274,19,1,5,5,10,f,Janet.jpg,pieFS1.bmp,Janet regularly fires employees to avoid promoting them.,1,reputation,283911,285162,1251,p,0
220274,20,2,8,12,20,f,Miriam.jpg,pieFS2.bmp,Miriam secretly gambles with her husband's savings.,1,reputation,297313,297962,649,p,0
220274,21,4,3,12,15,m,Daniel.jpg,pieFS4.bmp,Daniel employs illegal immigrants and pays them less than minimum wage.,1,reputation,310132,311222,1090,p,0
220274,22,5,1,9,10,f,Maria.jpg,pieFS5.bmp,Maria just received a huge cash settlement,1,resources,323401,324303,902,q,1
220274,23,4,1,4,5,m,Ben.jpg,pieFS4.bmp,Ben is a veteran having trouble finding employment.,2,na,336469,337843,1374,q,1
220274,24,2,7,10,17,f,Kelly.jpg,pieFS2.bmp,Kelly takes discarded food from grocery stores to feed her children.,2,na,350038,351163,1125,q,1
220274,25,4,3,12,15,f,Joanna.jpg,pieFS4.bmp,Joanna steals her coworkers' tips to buy alcohol.,1,reputation,363340,364123,783,p,0
220274,26,5,1,9,10,m,Edward.jpg,pieFS5.bmp,Edward could not afford his mortgage and his home was foreclosed.,2,na,376292,377223,931,q,1
220274,27,3,4,9,13,m,Saul.jpg,pieFS3.bmp,Saul stole his elderly father's prescription medications.,1,reputation,389394,390284,890,p,0
220274,28,3,5,11,16,m,Darnell.jpg,pieFS3.bmp,Darnell declared bankruptcy after he was laid off.,2,na,402446,403464,1018,q,1
220274,29,2,3,4,7,f,Fiona.jpg,pieFS2.bmp,Fiona claims false expenses for her reportable work travel.,1,reputation,415632,416604,972,p,0
220274,30,2,6,9,15,m,Peter.jpg,pieFS2.bmp,Peter takes valuables from his friends' homes when asked to house-sit.,1,reputation,428784,429724,940,p,0
220274,31,5,1,9,10,f,Sammy.jpg,pieFS5.bmp,Sammy just lost her small business after a franchise moved in next door.,2,na,441919,442805,886,q,1
220274,32,3,2,4,6,f,Eileen.jpg,pieFS3.bmp,Eileen used her mother's social security number to open a credit card account.,1,reputation,454971,455825,854,p,0
220274,33,2,3,4,7,m,Don.jpg,pieFS2.bmp,Don was injured in a hit-and-run accident and cannot afford his medical bills.,2,na,468007,468865,858,q,1
220274,34,5,1,9,10,f,Sharon.jpg,pieFS5.bmp,Sharon works as a cleaner in a hotel,2,na,481026,482005,979,q,1
220274,35,2,6,9,15,m,Kevin.jpg,pieFS2.bmp,Kevin was mugged and had his wallet stolen.,2,na,494161,495046,885,q,1
220274,36,4,1,4,5,m,Alan.jpg,pieFS4.bmp,Alan is hiding his taxable income in Switzerland.,1,reputation,507197,507926,729,p,0
220274,37,4,1,4,5,f,Jackie.jpg,pieFS4.bmp,Jackie is raising money to buy gifts for children in need.,2,na,520082,521086,1004,q,1
220274,38,4,2,8,10,m,Stuart.jpg,pieFS4.bmp,Stuart often goes through and steals the neighbors' mail.,1,reputation,533251,534226,975,p,0
220274,39,4,4,16,20,f,Trish.jpg,pieFS4.bmp,Trish's husband is a wealthy investment banker,1,resources,546403,547327,924,q,1
220274,40,3,3,7,10,f,Marny.jpg,pieFS3.bmp,Marny illegally parks in the disabled parking spots when she can.,1,reputation,559522,560087,565,p,0
220274,41,5,1,9,10,m,Jared.jpg,pieFS5.bmp,Jared underreports his company's earnings and pockets the profits.,1,reputation,572258,572767,509,p,0
220274,42,5,2,18,20,m,Ricky.jpg,pieFS5.bmp,Ricky is a well paid lawyer,1,resources,584927,585967,1040,q,1
220274,43,5,2,18,20,m,Jack.jpg,pieFS5.bmp,Jack has been unable to find a job for over a year.,2,na,598129,599028,899,q,1
220274,44,4,3,12,15,m,Justin.jpg,pieFS4.bmp,Justin is a retiree,2,na,611181,612028,847,q,1
220274,45,4,3,12,15,f,Jean.jpg,pieFS4.bmp,Jean's car with her bag and credit cards was recently stolen.,2,na,624200,625068,868,q,1
220274,46,4,4,16,20,m,Sam.jpg,pieFS4.bmp,Sam lost his house in a fire,2,na,637219,638108,889,q,1
220274,47,3,2,4,6,f,Kay.jpg,pieFS3.bmp,Kay can't afford to pay her medical bills,2,na,650271,651228,957,q,1
220274,48,3,3,7,10,f,Cindy.jpg,pieFS3.bmp,Cindy just found out that her husband has incurred a large credit card debt.,2,na,663423,664829,1406,q,1
220274,49,4,2,8,10,f,Fay.jpg,pieFS4.bmp,Fay is going to be evicted because she is behind on her rent,2,na,677025,677869,844,q,1
220274,50,5,1,9,10,f,Louise.jpg,pieFS5.bmp,Louise owns an international company,1,resources,690060,690869,809,q,1
220274,51,3,4,9,13,m,George.jpg,pieFS3.bmp,George just bought an expensive sports car,1,resources,703063,704289,1226,q,1
220274,52,5,2,18,20,f,Lauren.jpg,pieFS5.bmp,Lauren is a highly paid actress,1,resources,716481,717710,1229,q,1
220299,1,5,1,9,10,m,Sam.jpg,pieFS5.bmp,Sam declared bankruptcy after he was laid off.,2,na,42528,44891,2363,q,1
220299,2,4,3,12,15,m,Saul.jpg,pieFS4.bmp,Saul takes valuables from his friends' homes when asked to house-sit.,1,reputation,57078,58891,1813,p,0
220299,3,1,10,10,20,f,Arianna.jpg,pieFS1.bmp,Arianna is a single mother,2,na,71079,75171,4092,q,1
220299,4,5,1,9,10,m,Justin.jpg,pieFS5.bmp,Justin is hiding his taxable income in Switzerland.,1,reputation,87361,89352,1991,p,0
220299,5,3,2,4,6,f,Cindy.jpg,pieFS3.bmp,Cindy's car with her bag and credit cards was recently stolen.,2,na,101545,103592,2047,q,1
220299,6,4,2,8,10,f,Lauren.jpg,pieFS4.bmp,Lauren just found out that her husband has incurred a large credit card debt.,2,na,115779,119252,3473,q,1
220299,7,3,5,11,16,f,Jackie.jpg,pieFS3.bmp,Jackie is a highly paid actress,1,resources,131445,134832,3387,q,1
220299,8,1,9,9,18,m,Joe.jpg,pieFS1.bmp,Joe underreports his company's earnings and pockets the profits.,1,reputation,147027,148632,1605,q,1
220299,9,5,1,9,10,m,Mark.jpg,pieFS5.bmp,Mark was injured in a hit-and-run accident and cannot afford his medical bills.,2,na,160829,162732,1903,q,1
220299,10,3,3,7,10,f,Marny.jpg,pieFS3.bmp,Marny has to take an unpaid leave of absence because her mother broke her hip.,2,na,174930,176392,1462,q,1
220299,11,2,8,12,20,f,Louise.jpg,pieFS2.bmp,Louise just won the lottery,1,resources,188581,190793,2212,q,1
220299,12,3,2,4,6,f,Janet.jpg,pieFS3.bmp,Janet cannot afford to send her son to college.,2,na,202982,204353,1371,q,1
220299,13,1,5,5,10,f,Mary.jpg,pieFS1.bmp,Mary regularly fires employees to avoid promoting them.,1,reputation,216550,218113,1563,q,1
220299,14,4,3,12,15,m,Ben.jpg,pieFS4.bmp,Ben was mugged and had his wallet stolen.,2,na,230301,232073,1772,q,1
220299,15,3,3,7,10,f,Sharon.jpg,pieFS3.bmp,Sharon secretly gambles with her husband's savings.,1,reputation,244269,247453,3184,q,1
220299,16,3,2,4,6,f,Fay.jpg,pieFS3.bmp,Fay claims false expenses for her reportable work travel.,1,reputation,259652,261093,1441,q,1
220299,17,3,4,9,13,m,Tony.jpg,pieFS3.bmp,Tony often goes through and steals the neighbors' mail.,1,reputation,273286,276514,3228,q,1
220299,18,2,6,9,15,m,Stuart.jpg,pieFS2.bmp,Stuart has been unable to find a job for over a year.,2,na,288702,290454,1752,q,1
220299,19,2,3,4,7,f,Deborah.jpg,pieFS2.bmp,Deborah got a large cash bonus from her boss,1,resources,302687,304114,1427,q,1
220299,20,4,1,4,5,m,Daniel.jpg,pieFS4.bmp,Daniel is a well paid lawyer,1,resources,316355,318054,1699,p,0
220299,21,3,2,4,6,f,Jenny.jpg,pieFS3.bmp,Jenny was a victim of identity theft and is now thousands of dollars in debt.,2,na,330289,332334,2045,q,1
220299,22,4,4,16,20,m,Matt.jpg,pieFS4.bmp,Matt lost his house in a fire,2,na,344573,347595,3022,q,1
220299,23,3,4,9,13,m,Nick.jpg,pieFS3.bmp,Nick just found $50 on the street,1,resources,359823,362795,2972,q,1
220299,24,4,2,8,10,f,Sammy.jpg,pieFS4.bmp,Sammy works two waitressing jobs to pay her bills.,2,na,375039,376975,1936,q,1
220299,25,2,3,4,7,m,Peter.jpg,pieFS2.bmp,Peter is homeless,2,na,389207,391455,2248,q,1
220299,26,4,1,4,5,m,Jack.jpg,pieFS4.bmp,Jack is saving to pay his university fees,2,na,403674,406595,2921,q,1
220299,27,5,2,18,20,m,Brad.jpg,pieFS5.bmp,Brad lives in a luxury penthouse apartment,1,resources,418840,420275,1435,p,0
220299,28,3,6,14,20,m,Alan.jpg,pieFS3.bmp,Alan is a retiree,2,na,432508,435595,3087,q,1
220299,29,4,1,4,5,f,Fiona.jpg,pieFS4.bmp,Fiona works as a cleaner in a hotel,2,na,447825,451276,3451,q,1
220299,30,5,1,9,10,f,Jean.jpg,pieFS5.bmp,Jean just received a huge cash settlement,1,resources,463507,464936,1429,p,0
220299,31,3,4,9,13,m,Ian.jpg,pieFS3.bmp,Ian stole money from his mother's wallet.,1,reputation,477159,481856,4697,q,1
220299,32,2,7,10,17,f,Eileen.jpg,pieFS2.bmp,Eileen takes discarded food from grocery stores to feed her children.,2,na,494073,495516,1443,q,1
220299,33,3,5,11,16,m,Don.jpg,pieFS3.bmp,Don lost his life savings when his small business failed,2,na,507741,509056,1315,q,1
220299,34,5,2,18,20,m,Jared.jpg,pieFS5.bmp,Jared just bought an expensive sports car,1,resources,521276,525136,3860,q,1
220299,35,5,2,18,20,f,Miriam.jpg,pieFS5.bmp,Miriam's husband is a wealthy investment banker,1,resources,537341,539197,1856,p,0
220299,36,5,1,9,10,f,Kelly.jpg,pieFS5.bmp,Kelly steals her coworkers' tips to buy alcohol.,1,reputation,551426,553937,2511,p,0
220299,37,1,8,8,16,m,Edward.jpg,pieFS1.bmp,Edward is saving for his son's operation,2,na,566159,567817,1658,q,1
220299,38,4,3,12,15,f,Emily.jpg,pieFS4.bmp,Emily just lost her small business after a franchise moved in next door.,2,na,580044,582637,2593,q,1
220299,39,4,3,12,15,f,Maria.jpg,pieFS4.bmp,Maria used her mother's social security number to open a credit card account.,1,reputation,594860,599297,4437,p,0
220299,40,5,1,9,10,f,Emma.jpg,pieFS5.bmp,Emma can't afford to pay her medical bills,2,na,611525,614418,2893,q,1
220299,41,4,2,8,10,m,Paul.jpg,pieFS4.bmp,Paul bullies his employees to put in extra hours at work.,1,reputation,626658,628177,1519,p,0
220299,42,3,3,7,10,m,Michael.jpg,pieFS3.bmp,Michael cheated on his taxes and is now under investigation for tax fraud.,1,reputation,640409,642378,1969,q,1
220299,43,5,1,9,10,f,Beth.jpg,pieFS5.bmp,Beth is going to be evicted because she is behind on her rent,2,na,654610,657278,2668,q,1
220299,44,3,6,14,20,m,Kevin.jpg,pieFS3.bmp,Kevin is a veteran having trouble finding employment.,2,na,669510,671178,1668,q,1
220299,45,5,1,9,10,f,Kay.jpg,pieFS5.bmp,Kay owns an international company,1,resources,683428,684798,1370,p,0
220299,46,4,2,8,10,m,Darnell.jpg,pieFS4.bmp,Darnell stole his elderly father's prescription medications.,1,reputation,697029,698559,1530,p,0
220299,47,4,4,16,20,f,Trish.jpg,pieFS4.bmp,Trish received a large inheritance from a distant relative,1,resources,710781,712339,1558,p,0
220299,48,5,2,18,20,m,Taymar.jpg,pieFS5.bmp,Taymar just lost his job,2,na,724565,726319,1754,q,1
220299,49,2,6,9,15,m,Ricky.jpg,pieFS2.bmp,Ricky employs illegal immigrants and pays them less than minimum wage.,1,reputation,738550,740059,1509,q,1
220299,50,5,1,9,10,f,Monica.jpg,pieFS5.bmp,Monica is raising money to buy gifts for children in need.,2,na,752284,753839,1555,q,1
220299,51,4,4,16,20,f,Joanna.jpg,pieFS4.bmp,Joanna illegally parks in the disabled parking spots when she can.,1,reputation,766086,768199,2113,p,0
220299,52,5,2,18,20,m,George.jpg,pieFS5.bmp,George could not afford his mortgage and his home was foreclosed.,2,na,780436,784639,4203,q,1
220363,1,3,2,4,6,f,Marny.jpg,pieFS3.bmp,Marny takes discarded food from grocery stores to feed her children.,2,na,39794,41507,1713,z,1
220363,2,1,8,8,16,m,Ian.jpg,pieFS1.bmp,Ian declared bankruptcy after he was laid off.,2,na,53622,54768,1146,z,1
220363,3,3,4,9,13,m,Mark.jpg,pieFS3.bmp,Mark takes valuables from his friends' homes when asked to house-sit.,1,reputation,66865,69523,2658,z,1
220363,4,5,1,9,10,f,Beth.jpg,pieFS5.bmp,Beth secretly gambles with her husband's savings.,1,reputation,81630,83623,1993,m,0
220363,5,2,8,12,20,f,Eileen.jpg,pieFS2.bmp,Eileen steals her coworkers' tips to buy alcohol.,1,reputation,95725,97235,1510,m,0
220363,6,4,2,8,10,m,Joe.jpg,pieFS4.bmp,Joe just bought an expensive sports car,1,resources,109336,111165,1829,m,0
220363,7,5,1,9,10,m,Sam.jpg,pieFS5.bmp,Sam was injured in a hit-and-run accident and cannot afford his medical bills.,2,na,123265,124140,875,z,1
220363,8,3,5,11,16,f,Kay.jpg,pieFS3.bmp,Kay claims false expenses for her reportable work travel.,1,reputation,136240,138577,2337,m,0
220363,9,5,1,9,10,f,Kelly.jpg,pieFS5.bmp,Kelly just lost her small business after a franchise moved in next door.,2,na,150670,151401,731,z,1
220363,10,5,1,9,10,f,Monica.jpg,pieFS5.bmp,Monica used her mother's social security number to open a credit card account.,1,reputation,163495,164615,1120,m,0
220363,11,3,3,7,10,f,Louise.jpg,pieFS3.bmp,Louise works as a cleaner in a hotel,2,na,176705,177781,1076,z,1
220363,12,4,4,16,20,m,Matt.jpg,pieFS4.bmp,Matt was mugged and had his wallet stolen.,2,na,189881,191056,1175,z,1
220363,13,3,2,4,6,f,Trish.jpg,pieFS3.bmp,Trish's husband is a wealthy investment banker,1,resources,203157,206036,2879,z,1
220363,14,5,2,18,20,m,Edward.jpg,pieFS5.bmp,Edward is saving for his son's operation,2,na,218122,219044,922,z,1
220363,15,4,2,8,10,f,Jenny.jpg,pieFS4.bmp,Jenny is raising money to buy gifts for children in need.,2,na,231131,232061,930,z,1
220363,16,5,1,9,10,f,Deborah.jpg,pieFS5.bmp,Deborah illegally parks in the disabled parking spots when she can.,1,reputation,244157,245242,1085,m,0
220363,17,3,2,4,6,f,Maria.jpg,pieFS3.bmp,Maria's car with her bag and credit cards was recently stolen.,2,na,257333,258178,845,z,1
220363,18,4,2,8,10,f,Janet.jpg,pieFS4.bmp,Janet can't afford to pay her medical bills,2,na,270275,271060,785,z,1
220363,19,1,9,9,18,m,Michael.jpg,pieFS1.bmp,Michael often goes through and steals the neighbors' mail.,1,reputation,283150,283973,823,m,0
220363,20,3,6,14,20,m,Ben.jpg,pieFS3.bmp,Ben has been unable to find a job for over a year.,2,na,296058,296802,744,z,1
220363,21,5,1,9,10,f,Lauren.jpg,pieFS5.bmp,Lauren just found out that her husband has incurred a large credit card debt.,2,na,308900,309645,745,z,1
220363,22,4,1,4,5,f,Mary.jpg,pieFS4.bmp,Mary is going to be evicted because she is behind on her rent,2,na,321742,322582,840,z,1
220363,23,5,2,18,20,m,Stuart.jpg,pieFS5.bmp,Stuart lost his house in a fire,2,na,334650,335520,870,z,1
220363,24,3,4,9,13,m,Peter.jpg,pieFS3.bmp,Peter just found $50 on the street,1,resources,347609,348831,1222,z,1
220363,25,2,3,4,7,m,Don.jpg,pieFS2.bmp,Don is homeless,2,na,360902,361600,698,z,1
220363,26,4,1,4,5,m,Kevin.jpg,pieFS4.bmp,Kevin is saving to pay his university fees,2,na,373694,374349,655,z,1
220363,27,3,3,7,10,m,Ricky.jpg,pieFS3.bmp,Ricky bullies his employees to put in extra hours at work.,1,reputation,386435,387155,720,m,0
220363,28,2,3,4,7,f,Sammy.jpg,pieFS2.bmp,Sammy is a highly paid actress,1,resources,399226,400387,1161,z,1
220363,29,3,5,11,16,m,Taymar.jpg,pieFS3.bmp,Taymar just lost his job,2,na,412469,413405,936,z,1
220363,30,1,10,10,20,f,Joanna.jpg,pieFS1.bmp,Joanna has to take an unpaid leave of absence because her mother broke her hip.,2,na,425495,426247,752,z,1
220363,31,1,5,5,10,f,Fay.jpg,pieFS1.bmp,Fay owns an international company,1,resources,438337,439578,1241,z,1
220363,32,5,2,18,20,f,Fiona.jpg,pieFS5.bmp,Fiona received a large inheritance from a distant relative,1,resources,451663,452761,1098,z,1
220363,33,3,3,7,10,f,Jackie.jpg,pieFS3.bmp,Jackie got a large cash bonus from her boss,1,resources,464856,465916,1060,z,1
220363,34,5,2,18,20,m,Jared.jpg,pieFS5.bmp,Jared employs illegal immigrants and pays them less than minimum wage.,1,reputation,478015,481782,3767,m,0
220363,35,4,3,12,15,m,George.jpg,pieFS4.bmp,George could not afford his mortgage and his home was foreclosed.,2,na,493883,494551,668,z,1
220363,36,5,1,9,10,m,Jack.jpg,pieFS5.bmp,Jack lives in a luxury penthouse apartment,1,resources,506641,507338,697,z,1
220363,37,3,2,4,6,f,Emily.jpg,pieFS3.bmp,Emily was a victim of identity theft and is now thousands of dollars in debt.,2,na,519433,520158,725,z,1
220363,38,4,3,12,15,f,Arianna.jpg,pieFS4.bmp,Arianna is a single mother,2,na,532258,532988,730,z,1
220363,39,2,6,9,15,m,Nick.jpg,pieFS2.bmp,Nick stole money from his mother's wallet.,1,reputation,545083,546018,935,m,0
220363,40,3,6,14,20,m,Saul.jpg,pieFS3.bmp,Saul lost his life savings when his small business failed,2,na,558108,558599,491,z,1
220363,41,4,1,4,5,m,Brad.jpg,pieFS4.bmp,Brad cheated on his taxes and is now under investigation for tax fraud.,1,reputation,570699,571124,425,m,0
220363,42,2,6,9,15,m,Darnell.jpg,pieFS2.bmp,Darnell is a veteran having trouble finding employment.,2,na,583223,583850,627,z,1
220363,43,4,2,8,10,m,Alan.jpg,pieFS4.bmp,Alan is hiding his taxable income in Switzerland.,1,reputation,595948,596585,637,m,0
220363,44,2,7,10,17,f,Jean.jpg,pieFS2.bmp,Jean works two waitressing jobs to pay her bills.,2,na,608672,609353,681,z,1
220363,45,4,3,12,15,f,Sharon.jpg,pieFS4.bmp,Sharon just won the lottery,1,resources,621430,622140,710,z,1
220363,46,5,2,18,20,m,Tony.jpg,pieFS5.bmp,Tony stole his elderly father's prescription medications.,1,reputation,634239,634964,725,m,0
220363,47,5,1,9,10,f,Miriam.jpg,pieFS5.bmp,Miriam cannot afford to send her son to college.,2,na,647064,647410,346,z,1
220363,48,3,4,9,13,m,Daniel.jpg,pieFS3.bmp,Daniel underreports his company's earnings and pockets the profits.,1,reputation,659504,660239,735,m,0
220363,49,4,3,12,15,m,Justin.jpg,pieFS4.bmp,Justin is a well paid lawyer,1,resources,672329,673383,1054,z,1
220363,50,4,4,16,20,f,Emma.jpg,pieFS4.bmp,Emma regularly fires employees to avoid promoting them.,1,reputation,685471,685944,473,m,0
220363,51,5,1,9,10,m,Paul.jpg,pieFS5.bmp,Paul is a retiree,2,na,698012,698389,377,z,1
220363,52,4,4,16,20,f,Cindy.jpg,pieFS4.bmp,Cindy just received a huge cash settlement,1,resources,710486,716019,5533,z,1
220378,1,5,2,18,20,m,Stuart.jpg,pieFS5.bmp,Stuart stole his elderly father's prescription medications.,1,reputation,33355,37971,4616,m,0
220378,2,5,1,9,10,f,Louise.jpg,pieFS5.bmp,Louise's husband is a wealthy investment banker,1,resources,50059,55820,5761,m,0
220378,3,2,3,4,7,m,Ricky.jpg,pieFS2.bmp,Ricky could not afford his mortgage and his home was foreclosed.,2,na,67934,75190,7256,z,1
220378,4,4,2,8,10,f,Fiona.jpg,pieFS4.bmp,Fiona can't afford to pay her medical bills,2,na,87296,98332,11036,m,0
220378,5,3,4,9,13,m,Joe.jpg,pieFS3.bmp,Joe is hiding his taxable income in Switzerland.,1,reputation,110438,127771,17333,m,0
220378,6,2,6,9,15,m,Kevin.jpg,pieFS2.bmp,Kevin declared bankruptcy after he was laid off.,2,na,139867,144504,4637,z,1
220378,7,4,1,4,5,m,Saul.jpg,pieFS4.bmp,Saul takes valuables from his friends' homes when asked to house-sit.,1,reputation,156604,162243,5639,m,0
220378,8,5,1,9,10,m,Mark.jpg,pieFS5.bmp,Mark was injured in a hit-and-run accident and cannot afford his medical bills.,2,na,174329,177070,2741,m,0
220378,9,3,2,4,6,f,Jenny.jpg,pieFS3.bmp,Jenny steals her coworkers' tips to buy alcohol.,1,reputation,189160,196871,7711,z,1
220378,10,4,2,8,10,m,Daniel.jpg,pieFS4.bmp,Daniel underreports his company's earnings and pockets the profits.,1,reputation,208958,214514,5556,m,0
220378,11,1,8,8,16,m,Michael.jpg,pieFS1.bmp,Michael was mugged and had his wallet stolen.,2,na,226632,230302,3670,z,1
220378,12,4,1,4,5,f,Beth.jpg,pieFS4.bmp,Beth is going to be evicted because she is behind on her rent,2,na,242399,245235,2836,m,0
220378,13,5,1,9,10,f,Janet.jpg,pieFS5.bmp,Janet owns an international company,1,resources,257314,262438,5124,m,0
220378,14,5,1,9,10,m,Alan.jpg,pieFS5.bmp,Alan is a well paid lawyer,1,resources,274520,277868,3348,m,0
220378,15,5,1,9,10,f,Emily.jpg,pieFS5.bmp,Emily just lost her small business after a franchise moved in next door.,2,na,289954,293505,3551,m,0
220378,16,1,5,5,10,f,Monica.jpg,pieFS1.bmp,Monica used her mother's social security number to open a credit card account.,1,reputation,305604,308824,3220,z,1
220378,17,5,1,9,10,f,Lauren.jpg,pieFS5.bmp,Lauren is raising money to buy gifts for children in need.,2,na,320921,323842,2921,m,0
220378,18,5,1,9,10,f,Jackie.jpg,pieFS5.bmp,Jackie illegally parks in the disabled parking spots when she can.,1,reputation,335936,338271,2335,m,0
220378,19,3,6,14,20,m,Justin.jpg,pieFS3.bmp,Justin is a retiree,2,na,350349,353672,3323,m,0
220378,20,1,10,10,20,f,Maria.jpg,pieFS1.bmp,Maria's car with her bag and credit cards was recently stolen.,2,na,365766,368540,2774,z,1
220378,21,2,6,9,15,m,Brad.jpg,pieFS2.bmp,Brad often goes through and steals the neighbors' mail.,1,reputation,380631,385602,4971,z,1
220378,22,3,3,7,10,m,Taymar.jpg,pieFS3.bmp,Taymar just bought an expensive sports car,1,resources,397703,402664,4961,m,0
220378,23,5,2,18,20,f,Kay.jpg,pieFS5.bmp,Kay received a large inheritance from a distant relative,1,resources,414758,417344,2586,m,0
220378,24,3,2,4,6,f,Trish.jpg,pieFS3.bmp,Trish is a single mother,2,na,429422,432307,2885,z,1
220378,25,3,2,4,6,f,Marny.jpg,pieFS3.bmp,Marny just found out that her husband has incurred a large credit card debt.,2,na,444404,449699,5295,z,1
220378,26,3,5,11,16,m,Jared.jpg,pieFS3.bmp,Jared is saving for his son's operation,2,na,461777,465849,4072,m,0
220378,27,3,5,11,16,f,Miriam.jpg,pieFS3.bmp,Miriam just won the lottery,1,resources,477947,491048,13101,m,0
220378,28,4,4,16,20,f,Sammy.jpg,pieFS4.bmp,Sammy is a highly paid actress,1,resources,503128,505280,2152,m,0
220378,29,5,2,18,20,m,Sam.jpg,pieFS5.bmp,Sam has been unable to find a job for over a year.,2,na,517374,519341,1967,m,0
220378,30,5,1,9,10,m,Nick.jpg,pieFS5.bmp,Nick lost his house in a fire,2,na,531437,533440,2003,m,0
220378,31,4,3,12,15,f,Jean.jpg,pieFS4.bmp,Jean has to take an unpaid leave of absence because her mother broke her hip.,2,na,545532,547952,2420,m,0
220378,32,4,2,8,10,m,Darnell.jpg,pieFS4.bmp,Darnell just found $50 on the street,1,resources,560046,562439,2393,m,0
220378,33,5,2,18,20,m,Tony.jpg,pieFS5.bmp,Tony is homeless,2,na,574526,576862,2336,m,0
220378,34,4,2,8,10,f,Fay.jpg,pieFS4.bmp,Fay cannot afford to send her son to college.,2,na,588956,590907,1951,m,0
220378,35,3,4,9,13,m,George.jpg,pieFS3.bmp,George bullies his employees to put in extra hours at work.,1,reputation,603002,606206,3204,m,0
220378,36,2,8,12,20,f,Arianna.jpg,pieFS2.bmp,Arianna regularly fires employees to avoid promoting them.,1,reputation,618302,622380,4078,z,1
220378,37,3,6,14,20,m,Jack.jpg,pieFS3.bmp,Jack is saving to pay his university fees,2,na,634471,639787,5316,m,0
220378,38,4,3,12,15,f,Emma.jpg,pieFS4.bmp,Emma secretly gambles with her husband's savings.,1,reputation,651877,653980,2103,m,0
220378,39,3,3,7,10,f,Cindy.jpg,pieFS3.bmp,Cindy got a large cash bonus from her boss,1,resources,666056,669545,3489,m,0
220378,40,4,1,4,5,m,Edward.jpg,pieFS4.bmp,Edward just lost his job,2,na,681640,684372,2732,m,0
220378,41,5,1,9,10,f,Deborah.jpg,pieFS5.bmp,Deborah was a victim of identity theft and is now thousands of dollars in debt.,2,na,696472,698547,2075,m,0
220378,42,4,3,12,15,m,Paul.jpg,pieFS4.bmp,Paul employs illegal immigrants and pays them less than minimum wage.,1,reputation,710634,712646,2012,m,0
220378,43,5,2,18,20,m,Matt.jpg,pieFS5.bmp,Matt lives in a luxury penthouse apartment,1,resources,724747,726719,1972,m,0
220378,44,3,2,4,6,f,Kelly.jpg,pieFS3.bmp,Kelly works two waitressing jobs to pay her bills.,2,na,738809,742008,3199,z,1
220378,45,1,9,9,18,m,Ian.jpg,pieFS1.bmp,Ian stole money from his mother's wallet.,1,reputation,754109,756182,2073,z,1
220378,46,4,4,16,20,m,Peter.jpg,pieFS4.bmp,Peter lost his life savings when his small business failed,2,na,768271,771013,2742,m,0
220378,47,2,3,4,7,f,Sharon.jpg,pieFS2.bmp,Sharon claims false expenses for her reportable work travel.,1,reputation,783103,785676,2573,z,1
220378,48,4,4,16,20,f,Joanna.jpg,pieFS4.bmp,Joanna just received a huge cash settlement,1,resources,797767,799906,2139,m,0
220378,49,3,4,9,13,m,Don.jpg,pieFS3.bmp,Don cheated on his taxes and is now under investigation for tax fraud.,1,reputation,811996,817474,5478,m,0
220378,50,2,7,10,17,f,Mary.jpg,pieFS2.bmp,Mary works as a cleaner in a hotel,2,na,829570,832586,3016,z,1
220378,51,4,3,12,15,m,Ben.jpg,pieFS4.bmp,Ben is a veteran having trouble finding employment.,2,na,844686,847663,2977,m,0
220378,52,3,3,7,10,f,Eileen.jpg,pieFS3.bmp,Eileen takes discarded food from grocery stores to feed her children.,2,na,859768,863086,3318,m,0
220399,1,4,2,8,10,m,Edward.jpg,pieFS4.bmp,Edward is hiding his taxable income in Switzerland.,1,reputation,66089,79607,13518,p,0
220399,2,2,6,9,15,m,Ricky.jpg,pieFS2.bmp,Ricky underreports his company's earnings and pockets the profits.,1,reputation,91860,95987,4127,p,0
220399,3,5,1,9,10,m,Justin.jpg,pieFS5.bmp,Justin is a well paid lawyer,1,resources,108191,111447,3256,p,0
220399,4,5,2,18,20,m,Brad.jpg,pieFS5.bmp,Brad often goes through and steals the neighbors' mail.,1,reputation,123657,126267,2610,p,0
220399,5,4,4,16,20,f,Sharon.jpg,pieFS4.bmp,Sharon secretly gambles with her husband's savings.,1,reputation,138491,141007,2516,p,0
220399,6,3,5,11,16,m,Daniel.jpg,pieFS3.bmp,Daniel is a retiree,2,na,153224,155807,2583,q,1
220399,7,4,3,12,15,f,Cindy.jpg,pieFS4.bmp,Cindy is a highly paid actress,1,resources,168024,186767,18743,q,1
220399,8,5,1,9,10,m,Sam.jpg,pieFS5.bmp,Sam has been unable to find a job for over a year.,2,na,198989,202307,3318,q,1
220399,9,3,4,9,13,m,Taymar.jpg,pieFS3.bmp,Taymar just bought an expensive sports car,1,resources,214538,221587,7049,q,1
220399,10,5,1,9,10,f,Trish.jpg,pieFS5.bmp,Trish claims false expenses for her reportable work travel.,1,reputation,233800,236507,2707,p,0
220399,11,5,2,18,20,m,Ben.jpg,pieFS5.bmp,Ben lost his house in a fire,2,na,248750,252767,4017,q,1
220399,12,3,4,9,13,m,Tony.jpg,pieFS3.bmp,Tony just found $50 on the street,1,resources,265015,268247,3232,q,1
220399,13,5,2,18,20,m,Mark.jpg,pieFS5.bmp,Mark is homeless,2,na,280498,283047,2549,q,1
220399,14,3,2,4,6,f,Arianna.jpg,pieFS3.bmp,Arianna works as a cleaner in a hotel,2,na,295281,300647,5366,q,1
220399,15,4,3,12,15,f,Marny.jpg,pieFS4.bmp,Marny has to take an unpaid leave of absence because her mother broke her hip.,2,na,312878,315907,3029,q,1
220399,16,3,2,4,6,f,Joanna.jpg,pieFS3.bmp,Joanna got a large cash bonus from her boss,1,resources,328127,331288,3161,q,1
220399,17,1,8,8,16,m,Stuart.jpg,pieFS1.bmp,Stuart is saving to pay his university fees,2,na,343510,349267,5757,q,1
220399,18,5,2,18,20,m,Jack.jpg,pieFS5.bmp,Jack lives in a luxury penthouse apartment,1,resources,361490,364888,3398,p,0
220399,19,4,1,4,5,m,Don.jpg,pieFS4.bmp,Don stole money from his mother's wallet.,1,reputation,377156,379668,2512,p,0
220399,20,5,1,9,10,f,Jenny.jpg,pieFS5.bmp,Jenny was a victim of identity theft and is now thousands of dollars in debt.,2,na,391939,394568,2629,q,1
220399,21,5,1,9,10,f,Kelly.jpg,pieFS5.bmp,Kelly works two waitressing jobs to pay her bills.,2,na,406839,409768,2929,q,1
220399,22,5,1,9,10,m,Paul.jpg,pieFS5.bmp,Paul is saving for his son's operation,2,na,422005,424728,2723,q,1
220399,23,1,5,5,10,f,Sammy.jpg,pieFS1.bmp,Sammy just received a huge cash settlement,1,resources,436972,439248,2276,q,1
220399,24,4,1,4,5,m,Saul.jpg,pieFS4.bmp,Saul lost his life savings when his small business failed,2,na,451522,478026,26504,p,0
220399,25,4,3,12,15,m,Ian.jpg,pieFS4.bmp,Ian cheated on his taxes and is now under investigation for tax fraud.,1,reputation,490295,493188,2893,p,0
220399,26,3,2,4,6,f,Jackie.jpg,pieFS3.bmp,Jackie takes discarded food from grocery stores to feed her children.,2,na,505461,509248,3787,p,0
220399,27,4,4,16,20,f,Monica.jpg,pieFS4.bmp,Monica steals her coworkers' tips to buy alcohol.,1,reputation,521527,523688,2161,p,0
220399,28,4,3,12,15,m,Michael.jpg,pieFS4.bmp,Michael is a veteran having trouble finding employment.,2,na,535960,539348,3388,q,1
220399,29,1,9,9,18,m,Nick.jpg,pieFS1.bmp,Nick stole his elderly father's prescription medications.,1,reputation,551626,554188,2562,p,0
220399,30,2,3,4,7,m,Darnell.jpg,pieFS2.bmp,Darnell declared bankruptcy after he was laid off.,2,na,566459,570768,4309,q,1
220399,31,2,3,4,7,f,Emma.jpg,pieFS2.bmp,Emma's husband is a wealthy investment banker,1,resources,583041,585608,2567,q,1
220399,32,3,4,9,13,m,George.jpg,pieFS3.bmp,George bullies his employees to put in extra hours at work.,1,reputation,597874,601868,3994,p,0
220399,33,3,3,7,10,m,Kevin.jpg,pieFS3.bmp,Kevin takes valuables from his friends' homes when asked to house-sit.,1,reputation,614139,616428,2289,p,0
220399,34,4,1,4,5,f,Emily.jpg,pieFS4.bmp,Emily just lost her small business after a franchise moved in next door.,2,na,628706,634529,5823,q,1
220399,35,4,4,16,20,m,Joe.jpg,pieFS4.bmp,Joe just lost his job,2,na,646802,650849,4047,q,1
220399,36,5,1,9,10,f,Fay.jpg,pieFS5.bmp,Fay can't afford to pay her medical bills,2,na,663117,667008,3891,q,1
220399,37,3,5,11,16,f,Eileen.jpg,pieFS3.bmp,Eileen used her mother's social security number to open a credit card account.,1,reputation,679283,681469,2186,p,0
220399,38,1,10,10,20,f,Lauren.jpg,pieFS1.bmp,Lauren is raising money to buy gifts for children in need.,2,na,693750,701869,8119,q,1
220399,39,2,7,10,17,f,Fiona.jpg,pieFS2.bmp,Fiona is going to be evicted because she is behind on her rent,2,na,714143,717489,3346,q,1
220399,40,3,3,7,10,f,Louise.jpg,pieFS3.bmp,Louise owns an international company,1,resources,729742,741689,11947,q,1
220399,41,5,1,9,10,f,Kay.jpg,pieFS5.bmp,Kay received a large inheritance from a distant relative,1,resources,753932,764249,10317,p,0
220399,42,3,3,7,10,f,Miriam.jpg,pieFS3.bmp,Miriam is a single mother,2,na,776506,780129,3623,q,1
220399,43,5,1,9,10,f,Maria.jpg,pieFS5.bmp,Maria illegally parks in the disabled parking spots when she can.,1,reputation,792405,795929,3524,p,0
220399,44,5,2,18,20,f,Janet.jpg,pieFS5.bmp,Janet just won the lottery,1,resources,808204,813129,4925,p,0
220399,45,3,2,4,6,f,Mary.jpg,pieFS3.bmp,Mary cannot afford to send her son to college.,2,na,825385,828089,2704,q,1
220399,46,4,2,8,10,m,Jared.jpg,pieFS4.bmp,Jared employs illegal immigrants and pays them less than minimum wage.,1,reputation,840368,846009,5641,p,0
220399,47,3,6,14,20,m,Matt.jpg,pieFS3.bmp,Matt was injured in a hit-and-run accident and cannot afford his medical bills.,2,na,858281,861509,3228,q,1
220399,48,2,8,12,20,f,Beth.jpg,pieFS2.bmp,Beth regularly fires employees to avoid promoting them.,1,reputation,873747,877689,3942,p,0
220399,49,4,2,8,10,f,Jean.jpg,pieFS4.bmp,Jean's car with her bag and credit cards was recently stolen.,2,na,889929,892609,2680,q,1
220399,50,4,2,8,10,f,Deborah.jpg,pieFS4.bmp,Deborah just found out that her husband has incurred a large credit card debt.,2,na,904862,908129,3267,q,1
220399,51,2,6,9,15,m,Alan.jpg,pieFS2.bmp,Alan could not afford his mortgage and his home was foreclosed.,2,na,920345,924569,4224,q,1
220399,52,3,6,14,20,m,Peter.jpg,pieFS3.bmp,Peter was mugged and had his wallet stolen.,2,na,936776,940049,3273,q,1
220407,1,4,4,16,20,m,Brad.jpg,pieFS4.bmp,Brad lost his life savings when his small business failed,2,na,86196,88408,2212,q,1
220407,2,5,1,9,10,f,Miriam.jpg,pieFS5.bmp,Miriam is a single mother,2,na,100597,102868,2271,q,1
220407,3,5,2,18,20,m,Peter.jpg,pieFS5.bmp,Peter cheated on his taxes and is now under investigation for tax fraud.,1,reputation,115064,117609,2545,p,0
220407,4,5,1,9,10,f,Emma.jpg,pieFS5.bmp,Emma just won the lottery,1,resources,129781,133229,3448,p,0
220407,5,3,2,4,6,f,Fiona.jpg,pieFS3.bmp,Fiona cannot afford to send her son to college.,2,na,145397,148909,3512,q,1
220407,6,5,1,9,10,f,Mary.jpg,pieFS5.bmp,Mary regularly fires employees to avoid promoting them.,1,reputation,161080,163509,2429,p,0
220407,7,4,2,8,10,m,Alan.jpg,pieFS4.bmp,Alan employs illegal immigrants and pays them less than minimum wage.,1,reputation,175680,178190,2510,p,0
220407,8,5,1,9,10,f,Emily.jpg,pieFS5.bmp,Emily just lost her small business after a franchise moved in next door.,2,na,190364,194010,3646,p,0
220407,9,3,6,14,20,m,Ian.jpg,pieFS3.bmp,Ian is a veteran having trouble finding employment.,2,na,206163,208170,2007,q,1
220407,10,2,3,4,7,f,Sharon.jpg,pieFS2.bmp,Sharon secretly gambles with her husband's savings.,1,reputation,220347,222650,2303,q,1
220407,11,5,2,18,20,m,Justin.jpg,pieFS5.bmp,Justin could not afford his mortgage and his home was foreclosed.,2,na,234815,237471,2656,q,1
220407,12,2,8,12,20,f,Trish.jpg,pieFS2.bmp,Trish claims false expenses for her reportable work travel.,1,reputation,249632,253411,3779,q,1
220407,13,4,1,4,5,m,Kevin.jpg,pieFS4.bmp,Kevin stole his elderly father's prescription medications.,1,reputation,265564,268071,2507,p,0
220407,14,2,6,9,15,m,Edward.jpg,pieFS2.bmp,Edward is hiding his taxable income in Switzerland.,1,reputation,280231,283132,2901,q,1
220407,15,5,1,9,10,f,Fay.jpg,pieFS5.bmp,Fay works as a cleaner in a hotel,2,na,295298,299892,4594,q,1
220407,16,1,8,8,16,m,Michael.jpg,pieFS1.bmp,Michael declared bankruptcy after he was laid off.,2,na,312046,314232,2186,q,1
220407,17,5,1,9,10,f,Janet.jpg,pieFS5.bmp,Janet's husband is a wealthy investment banker,1,resources,326396,328932,2536,p,0
220407,18,3,4,9,13,m,Daniel.jpg,pieFS3.bmp,Daniel underreports his company's earnings and pockets the profits.,1,reputation,341097,343333,2236,q,1
220407,19,4,4,16,20,f,Jackie.jpg,pieFS4.bmp,Jackie used her mother's social security number to open a credit card account.,1,reputation,355531,360073,4542,p,0
220407,20,3,3,7,10,m,Stuart.jpg,pieFS3.bmp,Stuart takes valuables from his friends' homes when asked to house-sit.,1,reputation,372262,377693,5431,p,0
220407,21,5,1,9,10,m,Saul.jpg,pieFS5.bmp,Saul was injured in a hit-and-run accident and cannot afford his medical bills.,2,na,389876,391174,1298,q,1
220407,22,4,2,8,10,f,Jenny.jpg,pieFS4.bmp,Jenny is raising money to buy gifts for children in need.,2,na,403361,404474,1113,q,1
220407,23,3,3,7,10,f,Marny.jpg,pieFS3.bmp,Marny illegally parks in the disabled parking spots when she can.,1,reputation,416663,419914,3251,q,1
220407,24,1,10,10,20,f,Beth.jpg,pieFS1.bmp,Beth can't afford to pay her medical bills,2,na,432079,459002,26923,q,1
220407,25,3,4,9,13,m,Jared.jpg,pieFS3.bmp,Jared is a well paid lawyer,1,resources,471169,473275,2106,q,1
220407,26,3,5,11,16,m,Sam.jpg,pieFS3.bmp,Sam was mugged and had his wallet stolen.,2,na,485453,486335,882,q,1
220407,27,4,3,12,15,f,Kelly.jpg,pieFS4.bmp,Kelly's car with her bag and credit cards was recently stolen.,2,na,498505,499196,691,q,1
220407,28,2,7,10,17,f,Arianna.jpg,pieFS2.bmp,Arianna is going to be evicted because she is behind on her rent,2,na,511374,511756,382,q,1
220407,29,4,3,12,15,m,Don.jpg,pieFS4.bmp,Don often goes through and steals the neighbors' mail.,1,reputation,523927,524896,969,p,0
220407,30,4,3,12,15,m,Paul.jpg,pieFS4.bmp,Paul is a retiree,2,na,537046,539336,2290,q,1
220407,31,4,1,4,5,f,Monica.jpg,pieFS4.bmp,Monica just found out that her husband has incurred a large credit card debt.,2,na,551530,553837,2307,q,1
220407,32,3,2,4,6,f,Louise.jpg,pieFS3.bmp,Louise owns an international company,1,resources,566014,568717,2703,q,1
220407,33,4,4,16,20,f,Joanna.jpg,pieFS4.bmp,Joanna is a highly paid actress,1,resources,580864,583297,2433,q,1
220407,34,3,4,9,13,m,Ricky.jpg,pieFS3.bmp,Ricky just bought an expensive sports car,1,resources,595464,596937,1473,q,1
220407,35,3,6,14,20,m,Tony.jpg,pieFS3.bmp,Tony has been unable to find a job for over a year.,2,na,609099,609978,879,q,1
220407,36,3,2,4,6,f,Cindy.jpg,pieFS3.bmp,Cindy has to take an unpaid leave of absence because her mother broke her hip.,2,na,622168,622898,730,q,1
220407,37,5,2,18,20,m,Ben.jpg,pieFS5.bmp,Ben lost his house in a fire,2,na,635054,635498,444,q,1
220407,38,5,2,18,20,f,Sammy.jpg,pieFS5.bmp,Sammy got a large cash bonus from her boss,1,resources,647673,649658,1985,p,0
220407,39,2,6,9,15,m,Joe.jpg,pieFS2.bmp,Joe is saving for his son's operation,2,na,661824,664279,2455,q,1
220407,40,3,2,4,6,f,Lauren.jpg,pieFS3.bmp,Lauren was a victim of identity theft and is now thousands of dollars in debt.,2,na,676458,677359,901,q,1
220407,41,5,1,9,10,m,Darnell.jpg,pieFS5.bmp,Darnell just found $50 on the street,1,resources,689527,691959,2432,q,1
220407,42,5,1,9,10,m,Mark.jpg,pieFS5.bmp,Mark is homeless,2,na,704111,705019,908,q,1
220407,43,2,3,4,7,m,Matt.jpg,pieFS2.bmp,Matt is saving to pay his university fees,2,na,717196,718239,1043,q,1
220407,44,3,3,7,10,f,Eileen.jpg,pieFS3.bmp,Eileen works two waitressing jobs to pay her bills.,2,na,730398,730840,442,q,1
220407,45,3,5,11,16,f,Kay.jpg,pieFS3.bmp,Kay received a large inheritance from a distant relative,1,resources,743001,744000,999,q,1
220407,46,4,2,8,10,m,Taymar.jpg,pieFS4.bmp,Taymar bullies his employees to put in extra hours at work.,1,reputation,756153,757480,1327,p,0
220407,47,4,1,4,5,m,George.jpg,pieFS4.bmp,George just lost his job,2,na,769638,770061,423,q,1
220407,48,1,9,9,18,m,Nick.jpg,pieFS1.bmp,Nick lives in a luxury penthouse apartment,1,resources,782207,783261,1054,q,1
220407,49,1,5,5,10,f,Deborah.jpg,pieFS1.bmp,Deborah just received a huge cash settlement,1,resources,795476,796321,845,q,1
220407,50,5,2,18,20,m,Jack.jpg,pieFS5.bmp,Jack stole money from his mother's wallet.,1,reputation,808495,809581,1086,p,0
220407,51,4,2,8,10,f,Jean.jpg,pieFS4.bmp,Jean takes discarded food from grocery stores to feed her children.,2,na,821747,822342,595,q,1
220407,52,4,3,12,15,f,Maria.jpg,pieFS4.bmp,Maria steals her coworkers' tips to buy alcohol.,1,reputation,834516,836482,1966,p,0
220426,1,5,1,9,10,f,Beth.jpg,pieFS5.bmp,Beth's husband is a wealthy investment banker,1,resources,63333,65590,2257,p,0
220426,2,3,5,11,16,m,Justin.jpg,pieFS3.bmp,Justin just lost his job,2,na,77850,80671,2821,q,1
220426,3,3,3,7,10,f,Mary.jpg,pieFS3.bmp,Mary can't afford to pay her medical bills,2,na,92950,95151,2201,q,1
220426,4,3,4,9,13,m,Saul.jpg,pieFS3.bmp,Saul stole his elderly father's prescription medications.,1,reputation,107434,109291,1857,p,0
220426,5,4,3,12,15,f,Fiona.jpg,pieFS4.bmp,Fiona is going to be evicted because she is behind on her rent,2,na,121569,123851,2282,q,1
220426,6,4,2,8,10,f,Cindy.jpg,pieFS4.bmp,Cindy just found out that her husband has incurred a large credit card debt.,2,na,136119,139092,2973,p,0
220426,7,4,4,16,20,m,Jack.jpg,pieFS4.bmp,Jack declared bankruptcy after he was laid off.,2,na,151369,152752,1383,q,1
220426,8,5,1,9,10,m,Michael.jpg,pieFS5.bmp,Michael takes valuables from his friends' homes when asked to house-sit.,1,reputation,165020,166312,1292,p,0
220426,9,3,6,14,20,m,Kevin.jpg,pieFS3.bmp,Kevin was injured in a hit-and-run accident and cannot afford his medical bills.,2,na,178555,179792,1237,q,1
220426,10,3,3,7,10,f,Trish.jpg,pieFS3.bmp,Trish owns an international company,1,resources,192024,194513,2489,p,0
220426,11,3,5,11,16,f,Maria.jpg,pieFS3.bmp,Maria is a highly paid actress,1,resources,206757,210373,3616,q,1
220426,12,5,1,9,10,m,Brad.jpg,pieFS5.bmp,Brad was mugged and had his wallet stolen.,2,na,222623,224873,2250,q,1
220426,13,4,1,4,5,m,Peter.jpg,pieFS4.bmp,Peter often goes through and steals the neighbors' mail.,1,reputation,237140,238373,1233,p,0
220426,14,1,8,8,16,m,Darnell.jpg,pieFS1.bmp,Darnell has been unable to find a job for over a year.,2,na,250642,252474,1832,q,1
220426,15,3,2,4,6,f,Jenny.jpg,pieFS3.bmp,Jenny has to take an unpaid leave of absence because her mother broke her hip.,2,na,264743,267434,2691,q,1
220426,16,4,2,8,10,m,Ricky.jpg,pieFS4.bmp,Ricky employs illegal immigrants and pays them less than minimum wage.,1,reputation,279710,281214,1504,p,0
220426,17,2,3,4,7,f,Kelly.jpg,pieFS2.bmp,Kelly got a large cash bonus from her boss,1,resources,293494,296974,3480,q,1
220426,18,5,1,9,10,f,Emma.jpg,pieFS5.bmp,Emma received a large inheritance from a distant relative,1,resources,309227,310575,1348,p,0
220426,19,5,1,9,10,f,Jean.jpg,pieFS5.bmp,Jean was a victim of identity theft and is now thousands of dollars in debt.,2,na,322812,326095,3283,q,1
220426,20,3,2,4,6,f,Marny.jpg,pieFS3.bmp,Marny works two waitressing jobs to pay her bills.,2,na,338345,339535,1190,q,1
220426,21,5,2,18,20,m,Don.jpg,pieFS5.bmp,Don lost his house in a fire,2,na,351763,354396,2633,q,1
220426,22,2,3,4,7,m,Jared.jpg,pieFS2.bmp,Jared could not afford his mortgage and his home was foreclosed.,2,na,366630,368656,2026,q,1
220426,23,5,2,18,20,m,Ben.jpg,pieFS5.bmp,Ben just found $50 on the street,1,resources,380881,382936,2055,p,0
220426,24,4,2,8,10,f,Kay.jpg,pieFS4.bmp,Kay is a single mother,2,na,395165,396316,1151,q,1
220426,25,2,8,12,20,f,Monica.jpg,pieFS2.bmp,Monica just received a huge cash settlement,1,resources,408550,410117,1567,q,1
220426,26,5,2,18,20,m,Tony.jpg,pieFS5.bmp,Tony is homeless,2,na,422335,423657,1322,q,1
220426,27,3,4,9,13,m,Joe.jpg,pieFS3.bmp,Joe is hiding his taxable income in Switzerland.,1,reputation,435870,438257,2387,p,0
220426,28,5,1,9,10,m,Stuart.jpg,pieFS5.bmp,Stuart is saving to pay his university fees,2,na,450487,454097,3610,q,1
220426,29,3,2,4,6,f,Louise.jpg,pieFS3.bmp,Louise just won the lottery,1,resources,466319,469518,3199,p,0
220426,30,4,3,12,15,m,Mark.jpg,pieFS4.bmp,Mark lives in a luxury penthouse apartment,1,resources,481735,484098,2363,p,0
220426,31,1,10,10,20,f,Eileen.jpg,pieFS1.bmp,Eileen takes discarded food from grocery stores to feed her children.,2,na,496319,498098,1779,q,1
220426,32,5,1,9,10,f,Janet.jpg,pieFS5.bmp,Janet cannot afford to send her son to college.,2,na,510320,512519,2199,p,0
220426,33,4,2,8,10,m,Paul.jpg,pieFS4.bmp,Paul underreports his company's earnings and pockets the profits.,1,reputation,524738,526319,1581,p,0
220426,34,5,2,18,20,f,Jackie.jpg,pieFS5.bmp,Jackie steals her coworkers' tips to buy alcohol.,1,reputation,538539,539479,940,p,0
220426,35,2,7,10,17,f,Joanna.jpg,pieFS2.bmp,Joanna just lost her small business after a franchise moved in next door.,2,na,551708,553559,1851,q,1
220426,36,3,3,7,10,m,Alan.jpg,pieFS3.bmp,Alan is a well paid lawyer,1,resources,565792,569519,3727,q,1
220426,37,5,2,18,20,m,Matt.jpg,pieFS5.bmp,Matt stole money from his mother's wallet.,1,reputation,581741,583100,1359,p,0
220426,38,4,4,16,20,f,Arianna.jpg,pieFS4.bmp,Arianna regularly fires employees to avoid promoting them.,1,reputation,595326,596920,1594,p,0
220426,39,4,4,16,20,f,Sammy.jpg,pieFS4.bmp,Sammy used her mother's social security number to open a credit card account.,1,reputation,609144,610800,1656,p,0
220426,40,3,6,14,20,m,Taymar.jpg,pieFS3.bmp,Taymar is a retiree,2,na,623029,624680,1651,q,1
220426,41,1,5,5,10,f,Miriam.jpg,pieFS1.bmp,Miriam secretly gambles with her husband's savings.,1,reputation,636913,639681,2768,p,0
220426,42,5,1,9,10,f,Deborah.jpg,pieFS5.bmp,Deborah is raising money to buy gifts for children in need.,2,na,651913,652641,728,q,1
220426,43,2,6,9,15,m,Ian.jpg,pieFS2.bmp,Ian lost his life savings when his small business failed,2,na,664866,665821,955,q,1
220426,44,2,6,9,15,m,Nick.jpg,pieFS2.bmp,Nick cheated on his taxes and is now under investigation for tax fraud.,1,reputation,678051,680642,2591,p,0
220426,45,4,3,12,15,m,Sam.jpg,pieFS4.bmp,Sam is a veteran having trouble finding employment.,2,na,692868,693822,954,q,1
220426,46,1,9,9,18,m,Edward.jpg,pieFS1.bmp,Edward just bought an expensive sports car,1,resources,706053,707902,1849,q,1
220426,47,4,1,4,5,m,Daniel.jpg,pieFS4.bmp,Daniel is saving for his son's operation,2,na,720121,721102,981,q,1
220426,48,4,3,12,15,f,Sharon.jpg,pieFS4.bmp,Sharon claims false expenses for her reportable work travel.,1,reputation,733307,735263,1956,p,0
220426,49,4,1,4,5,f,Fay.jpg,pieFS4.bmp,Fay works as a cleaner in a hotel,2,na,747491,748423,932,q,1
220426,50,5,1,9,10,f,Lauren.jpg,pieFS5.bmp,Lauren illegally parks in the disabled parking spots when she can.,1,reputation,760643,762283,1640,p,0
220426,51,3,2,4,6,f,Emily.jpg,pieFS3.bmp,Emily's car with her bag and credit cards was recently stolen.,2,na,774511,776903,2392,q,1
220426,52,3,4,9,13,m,George.jpg,pieFS3.bmp,George bullies his employees to put in extra hours at work.,1,reputation,789111,795444,6333,q,1
220441,1,2,6,9,15,m,Jack.jpg,pieFS2.bmp,Jack is a veteran having trouble finding employment.,2,na,55373,73279,17906,q,1
220441,2,3,3,7,10,m,Darnell.jpg,pieFS3.bmp,Darnell stole his elderly father's prescription medications.,1,reputation,85539,92020,6481,p,0
220441,3,3,2,4,6,f,Kay.jpg,pieFS3.bmp,Kay owns an international company,1,resources,104268,110940,6672,q,1
220441,4,4,3,12,15,m,Edward.jpg,pieFS4.bmp,Edward is a well paid lawyer,1,resources,123197,127840,4643,q,1
220441,5,3,3,7,10,f,Janet.jpg,pieFS3.bmp,Janet received a large inheritance from a distant relative,1,resources,140112,142921,2809,q,1
220441,6,4,4,16,20,f,Eileen.jpg,pieFS4.bmp,Eileen is a highly paid actress,1,resources,155179,157561,2382,q,1
220441,7,4,2,8,10,f,Louise.jpg,pieFS4.bmp,Louise is a single mother,2,na,169812,171941,2129,q,1
220441,8,5,2,18,20,m,Michael.jpg,pieFS5.bmp,Michael declared bankruptcy after he was laid off.,2,na,184196,186501,2305,q,1
220441,9,4,1,4,5,m,Kevin.jpg,pieFS4.bmp,Kevin takes valuables from his friends' homes when asked to house-sit.,1,reputation,198730,200562,1832,q,1
220441,10,4,3,12,15,f,Emily.jpg,pieFS4.bmp,Emily has to take an unpaid leave of absence because her mother broke her hip.,2,na,212798,214522,1724,q,1
220441,11,4,4,16,20,m,Alan.jpg,pieFS4.bmp,Alan is a retiree,2,na,226749,227942,1193,q,1
220441,12,3,6,14,20,m,Don.jpg,pieFS3.bmp,Don was injured in a hit-and-run accident and cannot afford his medical bills.,2,na,240168,242082,1914,q,1
220441,13,3,5,11,16,m,Stuart.jpg,pieFS3.bmp,Stuart was mugged and had his wallet stolen.,2,na,254285,258503,4218,q,1
220441,14,5,2,18,20,m,Tony.jpg,pieFS5.bmp,Tony often goes through and steals the neighbors' mail.,1,reputation,270750,272343,1593,q,1
220441,15,5,1,9,10,f,Emma.jpg,pieFS5.bmp,Emma just won the lottery,1,resources,284568,287123,2555,q,1
220441,16,3,4,9,13,m,Jared.jpg,pieFS3.bmp,Jared just bought an expensive sports car,1,resources,299335,301884,2549,q,1
220441,17,2,7,10,17,f,Arianna.jpg,pieFS2.bmp,Arianna cannot afford to send her son to college.,2,na,314102,315644,1542,q,1
220441,18,5,1,9,10,f,Deborah.jpg,pieFS5.bmp,Deborah got a large cash bonus from her boss,1,resources,327870,332264,4394,q,1
220441,19,1,8,8,16,m,Saul.jpg,pieFS1.bmp,Saul has been unable to find a job for over a year.,2,na,344502,346044,1542,q,1
220441,20,3,6,14,20,m,Peter.jpg,pieFS3.bmp,Peter lost his house in a fire,2,na,358270,361645,3375,q,1
220441,21,3,5,11,16,f,Miriam.jpg,pieFS3.bmp,Miriam regularly fires employees to avoid promoting them.,1,reputation,373903,374885,982,q,1
220441,22,5,1,9,10,f,Jean.jpg,pieFS5.bmp,Jean was a victim of identity theft and is now thousands of dollars in debt.,2,na,387155,388585,1430,q,1
220441,23,4,4,16,20,f,Beth.jpg,pieFS4.bmp,Beth secretly gambles with her husband's savings.,1,reputation,400856,401585,729,q,1
220441,24,2,3,4,7,f,Trish.jpg,pieFS2.bmp,Trish claims false expenses for her reportable work travel.,1,reputation,413858,416126,2268,q,1
220441,25,5,2,18,20,m,Mark.jpg,pieFS5.bmp,Mark just found $50 on the street,1,resources,428359,433966,5607,q,1
220441,26,4,3,12,15,m,Joe.jpg,pieFS4.bmp,Joe is saving for his son's operation,2,na,446189,450646,4457,q,1
220441,27,5,1,9,10,m,Justin.jpg,pieFS5.bmp,Justin bullies his employees to put in extra hours at work.,1,reputation,462854,466967,4113,q,1
220441,28,5,1,9,10,m,Brad.jpg,pieFS5.bmp,Brad is homeless,2,na,479186,481307,2121,q,1
220441,29,5,1,9,10,f,Mary.jpg,pieFS5.bmp,Mary works as a cleaner in a hotel,2,na,493536,496967,3431,p,0
220441,30,3,2,4,6,f,Kelly.jpg,pieFS3.bmp,Kelly works two waitressing jobs to pay her bills.,2,na,509202,510267,1065,q,1
220441,31,5,1,9,10,f,Jackie.jpg,pieFS5.bmp,Jackie just received a huge cash settlement,1,resources,522471,524328,1857,q,1
220441,32,5,2,18,20,m,Ian.jpg,pieFS5.bmp,Ian is saving to pay his university fees,2,na,536539,539548,3009,q,1
220441,33,4,2,8,10,m,Ben.jpg,pieFS4.bmp,Ben lives in a luxury penthouse apartment,1,resources,551772,553868,2096,q,1
220441,34,4,1,4,5,m,George.jpg,pieFS4.bmp,George just lost his job,2,na,566073,567608,1535,q,1
220441,35,3,4,9,13,m,Nick.jpg,pieFS3.bmp,Nick stole money from his mother's wallet.,1,reputation,579807,581588,1781,q,1
220441,36,1,10,10,20,f,Marny.jpg,pieFS1.bmp,Marny takes discarded food from grocery stores to feed her children.,2,na,593808,595889,2081,q,1
220441,37,1,5,5,10,f,Fiona.jpg,pieFS1.bmp,Fiona's husband is a wealthy investment banker,1,resources,608109,608969,860,q,1
220441,38,5,2,18,20,f,Sammy.jpg,pieFS5.bmp,Sammy steals her coworkers' tips to buy alcohol.,1,reputation,621195,622409,1214,q,1
220441,39,4,2,8,10,f,Jenny.jpg,pieFS4.bmp,Jenny just lost her small business after a franchise moved in next door.,2,na,634613,636909,2296,q,1
220441,40,4,3,12,15,f,Cindy.jpg,pieFS4.bmp,Cindy used her mother's social security number to open a credit card account.,1,reputation,649130,650290,1160,q,1
220441,41,2,3,4,7,m,Sam.jpg,pieFS2.bmp,Sam lost his life savings when his small business failed,2,na,662499,668890,6391,q,1
220441,42,1,9,9,18,m,Daniel.jpg,pieFS1.bmp,Daniel employs illegal immigrants and pays them less than minimum wage.,1,reputation,681112,682930,1818,q,1
220441,43,3,3,7,10,f,Fay.jpg,pieFS3.bmp,Fay can't afford to pay her medical bills,2,na,695163,696731,1568,q,1
220441,44,5,1,9,10,m,Ricky.jpg,pieFS5.bmp,Ricky could not afford his mortgage and his home was foreclosed.,2,na,708947,710951,2004,q,1
220441,45,4,1,4,5,f,Lauren.jpg,pieFS4.bmp,Lauren is raising money to buy gifts for children in need.,2,na,723182,725751,2569,q,1
220441,46,4,2,8,10,m,Taymar.jpg,pieFS4.bmp,Taymar is hiding his taxable income in Switzerland.,1,reputation,737965,739211,1246,q,1
220441,47,3,2,4,6,f,Sharon.jpg,pieFS3.bmp,Sharon is going to be evicted because she is behind on her rent,2,na,751417,752452,1035,q,1
220441,48,2,8,12,20,f,Joanna.jpg,pieFS2.bmp,Joanna illegally parks in the disabled parking spots when she can.,1,reputation,764652,770012,5360,q,1
220441,49,3,2,4,6,f,Maria.jpg,pieFS3.bmp,Maria's car with her bag and credit cards was recently stolen.,2,na,782249,783172,923,q,1
220441,50,2,6,9,15,m,Matt.jpg,pieFS2.bmp,Matt cheated on his taxes and is now under investigation for tax fraud.,1,reputation,795401,797152,1751,q,1
220441,51,5,1,9,10,f,Monica.jpg,pieFS5.bmp,Monica just found out that her husband has incurred a large credit card debt.,2,na,809369,811853,2484,q,1
220441,52,3,4,9,13,m,Paul.jpg,pieFS3.bmp,Paul underreports his company's earnings and pockets the profits.,1,reputation,824070,824613,543,q,1
220451,1,5,2,18,20,m,Ricky.jpg,pieFS5.bmp,Ricky is a well paid lawyer,1,resources,55301,60549,5248,p,0
220451,2,4,1,4,5,f,Emily.jpg,pieFS4.bmp,Emily is raising money to buy gifts for children in need.,2,na,72831,86488,13657,q,1
220451,3,3,3,7,10,f,Louise.jpg,pieFS3.bmp,Louise can't afford to pay her medical bills,2,na,98768,101968,3200,q,1
220451,4,3,2,4,6,f,Monica.jpg,pieFS3.bmp,Monica illegally parks in the disabled parking spots when she can.,1,reputation,114251,117988,3737,p,0
220451,5,5,2,18,20,m,Stuart.jpg,pieFS5.bmp,Stuart is homeless,2,na,130266,132888,2622,q,1
220451,6,5,1,9,10,f,Fiona.jpg,pieFS5.bmp,Fiona is going to be evicted because she is behind on her rent,2,na,145149,147908,2759,q,1
220451,7,5,1,9,10,m,Justin.jpg,pieFS5.bmp,Justin is a retiree,2,na,160165,176148,15983,p,0
220451,8,5,1,9,10,m,George.jpg,pieFS5.bmp,George just bought an expensive sports car,1,resources,188417,191428,3011,p,0
220451,9,3,2,4,6,f,Maria.jpg,pieFS3.bmp,Maria's car with her bag and credit cards was recently stolen.,2,na,203683,206788,3105,p,0
220451,10,1,8,8,16,m,Alan.jpg,pieFS1.bmp,Alan is saving for his son's operation,2,na,219065,221748,2683,q,1
220451,11,3,5,11,16,m,Brad.jpg,pieFS3.bmp,Brad is saving to pay his university fees,2,na,234015,234148,133,q,1
220451,12,1,10,10,20,f,Lauren.jpg,pieFS1.bmp,Lauren just found out that her husband has incurred a large credit card debt.,2,na,246418,249988,3570,q,1
220451,13,3,4,9,13,m,Darnell.jpg,pieFS3.bmp,Darnell lives in a luxury penthouse apartment,1,resources,262266,266088,3822,p,0
220451,14,4,2,8,10,m,Peter.jpg,pieFS4.bmp,Peter stole money from his mother's wallet.,1,reputation,278365,282008,3643,p,0
220451,15,3,6,14,20,m,Jack.jpg,pieFS3.bmp,Jack lost his life savings when his small business failed,2,na,294280,304648,10368,p,0
220451,16,3,4,9,13,m,Don.jpg,pieFS3.bmp,Don cheated on his taxes and is now under investigation for tax fraud.,1,reputation,316921,319828,2907,p,0
220451,17,4,4,16,20,f,Janet.jpg,pieFS4.bmp,Janet owns an international company,1,resources,332104,335328,3224,p,0
220451,18,4,4,16,20,f,Jackie.jpg,pieFS4.bmp,Jackie is a highly paid actress,1,resources,347586,350648,3062,p,0
220451,19,2,7,10,17,f,Sammy.jpg,pieFS2.bmp,Sammy has to take an unpaid leave of absence because her mother broke her hip.,2,na,362919,368307,5388,q,1
220451,20,4,2,8,10,m,Taymar.jpg,pieFS4.bmp,Taymar bullies his employees to put in extra hours at work.,1,reputation,380582,385128,4546,p,0
220451,21,5,1,9,10,m,Edward.jpg,pieFS5.bmp,Edward just lost his job,2,na,397397,400027,2630,q,1
220451,22,3,3,7,10,f,Emma.jpg,pieFS3.bmp,Emma received a large inheritance from a distant relative,1,resources,412296,415987,3691,p,0
220451,23,4,4,16,20,m,Ben.jpg,pieFS4.bmp,Ben is a veteran having trouble finding employment.,2,na,428262,430927,2665,q,1
220451,24,4,2,8,10,f,Mary.jpg,pieFS4.bmp,Mary is a single mother,2,na,443195,447527,4332,q,1
220451,25,1,5,5,10,f,Jean.jpg,pieFS1.bmp,Jean got a large cash bonus from her boss,1,resources,459793,462547,2754,q,1
220451,26,2,6,9,15,m,Daniel.jpg,pieFS2.bmp,Daniel employs illegal immigrants and pays them less than minimum wage.,1,reputation,474826,479147,4321,p,0
220451,27,3,6,14,20,m,Paul.jpg,pieFS3.bmp,Paul could not afford his mortgage and his home was foreclosed.,2,na,491424,494287,2863,p,0
220451,28,3,4,9,13,m,Tony.jpg,pieFS3.bmp,Tony stole his elderly father's prescription medications.,1,reputation,506556,510247,3691,p,0
220451,29,5,1,9,10,f,Deborah.jpg,pieFS5.bmp,Deborah was a victim of identity theft and is now thousands of dollars in debt.,2,na,522522,525247,2725,p,0
220451,30,4,2,8,10,f,Kelly.jpg,pieFS4.bmp,Kelly works two waitressing jobs to pay her bills.,2,na,537521,540087,2566,q,1
220451,31,3,5,11,16,f,Beth.jpg,pieFS3.bmp,Beth just won the lottery,1,resources,552338,555367,3029,p,0
220451,32,3,2,4,6,f,Kay.jpg,pieFS3.bmp,Kay cannot afford to send her son to college.,2,na,567637,570827,3190,q,1
220451,33,2,3,4,7,f,Fay.jpg,pieFS2.bmp,Fay regularly fires employees to avoid promoting them.,1,reputation,583103,585907,2804,p,0
220451,34,5,2,18,20,m,Nick.jpg,pieFS5.bmp,Nick declared bankruptcy after he was laid off.,2,na,598186,602526,4340,p,0
220451,35,4,1,4,5,m,Matt.jpg,pieFS4.bmp,Matt takes valuables from his friends' homes when asked to house-sit.,1,reputation,614801,617966,3165,p,0
220451,36,5,1,9,10,f,Joanna.jpg,pieFS5.bmp,Joanna just received a huge cash settlement,1,resources,630233,632826,2593,p,0
220451,37,5,2,18,20,f,Sharon.jpg,pieFS5.bmp,Sharon secretly gambles with her husband's savings.,1,reputation,645083,647426,2343,p,0
220451,38,5,1,9,10,f,Cindy.jpg,pieFS5.bmp,Cindy takes discarded food from grocery stores to feed her children.,2,na,659666,662166,2500,q,1
220451,39,5,1,9,10,f,Jenny.jpg,pieFS5.bmp,Jenny steals her coworkers' tips to buy alcohol.,1,reputation,674400,679906,5506,p,0
220451,40,4,3,12,15,f,Marny.jpg,pieFS4.bmp,Marny just lost her small business after a franchise moved in next door.,2,na,692163,695906,3743,q,1
220451,41,2,8,12,20,f,Trish.jpg,pieFS2.bmp,Trish claims false expenses for her reportable work travel.,1,reputation,708178,711026,2848,p,0
220451,42,2,3,4,7,m,Mark.jpg,pieFS2.bmp,Mark was injured in a hit-and-run accident and cannot afford his medical bills.,2,na,723294,727226,3932,p,0
220451,43,4,3,12,15,m,Sam.jpg,pieFS4.bmp,Sam was mugged and had his wallet stolen.,2,na,739476,747186,7710,p,0
220451,44,5,1,9,10,f,Eileen.jpg,pieFS5.bmp,Eileen used her mother's social security number to open a credit card account.,1,reputation,759453,761846,2393,p,0
220451,45,3,2,4,6,f,Arianna.jpg,pieFS3.bmp,Arianna works as a cleaner in a hotel,2,na,774104,777526,3422,q,1
220451,46,3,3,7,10,m,Saul.jpg,pieFS3.bmp,Saul often goes through and steals the neighbors' mail.,1,reputation,789802,792826,3024,p,0
220451,47,2,6,9,15,m,Kevin.jpg,pieFS2.bmp,Kevin has been unable to find a job for over a year.,2,na,805102,810266,5164,q,1
220451,48,5,2,18,20,m,Joe.jpg,pieFS5.bmp,Joe is hiding his taxable income in Switzerland.,1,reputation,822499,824826,2327,p,0
220451,49,4,3,12,15,f,Miriam.jpg,pieFS4.bmp,Miriam's husband is a wealthy investment banker,1,resources,837049,839066,2017,p,0
220451,50,4,1,4,5,m,Michael.jpg,pieFS4.bmp,Michael lost his house in a fire,2,na,851299,853666,2367,q,1
220451,51,1,9,9,18,m,Ian.jpg,pieFS1.bmp,Ian just found $50 on the street,1,resources,865900,874306,8406,q,1
220451,52,4,3,12,15,m,Jared.jpg,pieFS4.bmp,Jared underreports his company's earnings and pockets the profits.,1,reputation,886526,889386,2860,p,0
220477,1,3,3,7,10,f,Miriam.jpg,pieFS3.bmp,Miriam regularly fires employees to avoid promoting them.,1,reputation,32519,34481,1962,q,1
220477,2,3,3,7,10,m,Peter.jpg,pieFS3.bmp,Peter stole his elderly father's prescription medications.,1,reputation,46737,47781,1044,q,1
220477,3,3,5,11,16,f,Trish.jpg,pieFS3.bmp,Trish secretly gambles with her husband's savings.,1,reputation,60055,60782,727,q,1
220477,4,3,2,4,6,f,Fay.jpg,pieFS3.bmp,Fay claims false expenses for her reportable work travel.,1,reputation,73057,74002,945,q,1
220477,5,1,10,10,20,f,Arianna.jpg,pieFS1.bmp,Arianna works as a cleaner in a hotel,2,na,86259,87242,983,q,1
220477,6,5,1,9,10,f,Fiona.jpg,pieFS5.bmp,Fiona's husband is a wealthy investment banker,1,resources,99495,100402,907,q,1
220477,7,4,2,8,10,f,Emma.jpg,pieFS4.bmp,Emma can't afford to pay her medical bills,2,na,112647,113522,875,q,1
220477,8,5,1,9,10,f,Maria.jpg,pieFS5.bmp,Maria was a victim of identity theft and is now thousands of dollars in debt.,2,na,125765,126542,777,q,1
220477,9,4,4,16,20,m,Jared.jpg,pieFS4.bmp,Jared could not afford his mortgage and his home was foreclosed.,2,na,138801,139822,1021,q,1
220477,10,2,6,9,15,m,Paul.jpg,pieFS2.bmp,Paul is hiding his taxable income in Switzerland.,1,reputation,152069,152782,713,q,1
220477,11,4,2,8,10,m,Joe.jpg,pieFS4.bmp,Joe underreports his company's earnings and pockets the profits.,1,reputation,165055,165823,768,q,1
220477,12,5,1,9,10,m,Saul.jpg,pieFS5.bmp,Saul declared bankruptcy after he was laid off.,2,na,178073,179343,1270,q,1
220477,13,3,4,9,13,m,Michael.jpg,pieFS3.bmp,Michael takes valuables from his friends' homes when asked to house-sit.,1,reputation,191608,193983,2375,q,1
220477,14,3,3,7,10,f,Beth.jpg,pieFS3.bmp,Beth is going to be evicted because she is behind on her rent,2,na,206242,206943,701,q,1
220477,15,5,1,9,10,f,Sharon.jpg,pieFS5.bmp,Sharon owns an international company,1,resources,219194,221223,2029,q,1
220477,16,5,1,9,10,f,Eileen.jpg,pieFS5.bmp,Eileen works two waitressing jobs to pay her bills.,2,na,233445,234263,818,q,1
220477,17,1,8,8,16,m,Ben.jpg,pieFS1.bmp,Ben was injured in a hit-and-run accident and cannot afford his medical bills.,2,na,246497,248283,1786,q,1
220477,18,3,5,11,16,m,Nick.jpg,pieFS3.bmp,Nick was mugged and had his wallet stolen.,2,na,260515,261144,629,q,1
220477,19,2,8,12,20,f,Joanna.jpg,pieFS2.bmp,Joanna just received a huge cash settlement,1,resources,273367,274444,1077,q,1
220477,20,5,1,9,10,f,Mary.jpg,pieFS5.bmp,Mary received a large inheritance from a distant relative,1,resources,286669,288084,1415,q,1
220477,21,4,3,12,15,f,Emily.jpg,pieFS4.bmp,Emily takes discarded food from grocery stores to feed her children.,2,na,300303,300884,581,q,1
220477,22,4,4,16,20,f,Sammy.jpg,pieFS4.bmp,Sammy steals her coworkers' tips to buy alcohol.,1,reputation,313122,315224,2102,q,1
220477,23,2,7,10,17,f,Janet.jpg,pieFS2.bmp,Janet is a single mother,2,na,327456,329525,2069,q,1
220477,24,5,2,18,20,m,Stuart.jpg,pieFS5.bmp,Stuart often goes through and steals the neighbors' mail.,1,reputation,341774,343304,1530,q,1
220477,25,3,6,14,20,m,Jack.jpg,pieFS3.bmp,Jack has been unable to find a job for over a year.,2,na,355575,356845,1270,q,1
220477,26,4,2,8,10,f,Lauren.jpg,pieFS4.bmp,Lauren just lost her small business after a franchise moved in next door.,2,na,369077,370445,1368,q,1
220477,27,3,4,9,13,m,Taymar.jpg,pieFS3.bmp,Taymar is a well paid lawyer,1,resources,382678,383385,707,q,1
220477,28,5,2,18,20,m,Sam.jpg,pieFS5.bmp,Sam lost his house in a fire,2,na,395614,396465,851,q,1
220477,29,5,2,18,20,m,Daniel.jpg,pieFS5.bmp,Daniel is a retiree,2,na,408699,410125,1426,q,1
220477,30,4,2,8,10,m,Mark.jpg,pieFS4.bmp,Mark just found $50 on the street,1,resources,422334,423365,1031,q,1
220477,31,3,6,14,20,m,Don.jpg,pieFS3.bmp,Don is homeless,2,na,435586,436506,920,q,1
220477,32,4,4,16,20,f,Kelly.jpg,pieFS4.bmp,Kelly used her mother's social security number to open a credit card account.,1,reputation,448738,450886,2148,q,1
220477,33,4,1,4,5,m,Justin.jpg,pieFS4.bmp,Justin just bought an expensive sports car,1,resources,463121,464526,1405,q,1
220477,34,4,3,12,15,m,Tony.jpg,pieFS4.bmp,Tony is saving to pay his university fees,2,na,476756,477546,790,q,1
220477,35,3,2,4,6,f,Marny.jpg,pieFS3.bmp,Marny is raising money to buy gifts for children in need.,2,na,489775,490466,691,q,1
220477,36,5,1,9,10,m,Ricky.jpg,pieFS5.bmp,Ricky is saving for his son's operation,2,na,502694,503786,1092,q,1
220477,37,2,3,4,7,f,Jean.jpg,pieFS2.bmp,Jean illegally parks in the disabled parking spots when she can.,1,reputation,516012,516927,915,q,1
220477,38,3,2,4,6,f,Jackie.jpg,pieFS3.bmp,Jackie's car with her bag and credit cards was recently stolen.,2,na,529164,529947,783,q,1
220477,39,3,4,9,13,m,George.jpg,pieFS3.bmp,George bullies his employees to put in extra hours at work.,1,reputation,542183,542967,784,q,1
220477,40,1,9,9,18,m,Kevin.jpg,pieFS1.bmp,Kevin lives in a luxury penthouse apartment,1,resources,555202,556687,1485,q,1
220477,41,5,1,9,10,m,Matt.jpg,pieFS5.bmp,Matt stole money from his mother's wallet.,1,reputation,568937,570207,1270,q,1
220477,42,4,1,4,5,m,Edward.jpg,pieFS4.bmp,Edward just lost his job,2,na,582455,583907,1452,q,1
220477,43,4,3,12,15,m,Alan.jpg,pieFS4.bmp,Alan employs illegal immigrants and pays them less than minimum wage.,1,reputation,596156,597847,1691,q,1
220477,44,2,6,9,15,m,Brad.jpg,pieFS2.bmp,Brad lost his life savings when his small business failed,2,na,610091,611288,1197,q,1
220477,45,5,2,18,20,f,Kay.jpg,pieFS5.bmp,Kay just won the lottery,1,resources,623542,625348,1806,q,1
220477,46,5,2,18,20,m,Ian.jpg,pieFS5.bmp,Ian cheated on his taxes and is now under investigation for tax fraud.,1,reputation,637610,640408,2798,q,1
220477,47,4,1,4,5,f,Jenny.jpg,pieFS4.bmp,Jenny just found out that her husband has incurred a large credit card debt.,2,na,652660,654248,1588,q,1
220477,48,4,3,12,15,f,Monica.jpg,pieFS4.bmp,Monica is a highly paid actress,1,resources,666528,667568,1040,q,1
220477,49,3,2,4,6,f,Cindy.jpg,pieFS3.bmp,Cindy has to take an unpaid leave of absence because her mother broke her hip.,2,na,679846,680548,702,q,1
220477,50,1,5,5,10,f,Deborah.jpg,pieFS1.bmp,Deborah got a large cash bonus from her boss,1,resources,692815,693688,873,q,1
220477,51,5,1,9,10,f,Louise.jpg,pieFS5.bmp,Louise cannot afford to send her son to college.,2,na,705950,706609,659,q,1
220477,52,2,3,4,7,m,Darnell.jpg,pieFS2.bmp,Darnell is a veteran having trouble finding employment.,2,na,718869,719749,880,q,1
220492,1,1,5,5,10,f,Emily.jpg,pieFS1.bmp,Emily used her mother's social security number to open a credit card account.,1,reputation,57516,61758,4242,q,1
220492,2,4,4,16,20,f,Emma.jpg,pieFS4.bmp,Emma just won the lottery,1,resources,74014,78978,4964,q,1
220492,3,5,1,9,10,f,Lauren.jpg,pieFS5.bmp,Lauren is raising money to buy gifts for children in need.,2,na,91245,94038,2793,p,0
220492,4,2,3,4,7,m,Justin.jpg,pieFS2.bmp,Justin is a retiree,2,na,106311,108818,2507,q,1
220492,5,5,2,18,20,m,Ben.jpg,pieFS5.bmp,Ben takes valuables from his friends' homes when asked to house-sit.,1,reputation,121061,123478,2417,p,0
220492,6,2,8,12,20,f,Jackie.jpg,pieFS2.bmp,Jackie illegally parks in the disabled parking spots when she can.,1,reputation,135695,138619,2924,q,1
220492,7,3,2,4,6,f,Marny.jpg,pieFS3.bmp,Marny's car with her bag and credit cards was recently stolen.,2,na,150844,155339,4495,q,1
220492,8,4,3,12,15,m,Edward.jpg,pieFS4.bmp,Edward just bought an expensive sports car,1,resources,167576,172559,4983,p,0
220492,9,2,7,10,17,f,Kelly.jpg,pieFS2.bmp,Kelly just found out that her husband has incurred a large credit card debt.,2,na,184806,186999,2193,q,1
220492,10,5,1,9,10,f,Monica.jpg,pieFS5.bmp,Monica is a highly paid actress,1,resources,199240,201699,2459,p,0
220492,11,3,5,11,16,m,Stuart.jpg,pieFS3.bmp,Stuart was injured in a hit-and-run accident and cannot afford his medical bills.,2,na,213957,216219,2262,q,1
220492,12,4,1,4,5,f,Jenny.jpg,pieFS4.bmp,Jenny has to take an unpaid leave of absence because her mother broke her hip.,2,na,228474,231819,3345,p,0
220492,13,4,3,12,15,f,Louise.jpg,pieFS4.bmp,Louise cannot afford to send her son to college.,2,na,244073,246939,2866,q,1
220492,14,3,6,14,20,m,Jared.jpg,pieFS3.bmp,Jared is saving for his son's operation,2,na,259189,261359,2170,q,1
220492,15,2,3,4,7,f,Trish.jpg,pieFS2.bmp,Trish regularly fires employees to avoid promoting them.,1,reputation,273623,275979,2356,q,1
220492,16,4,4,16,20,m,Kevin.jpg,pieFS4.bmp,Kevin was mugged and had his wallet stolen.,2,na,288207,290739,2532,q,1
220492,17,4,2,8,10,m,Sam.jpg,pieFS4.bmp,Sam often goes through and steals the neighbors' mail.,1,reputation,302957,305799,2842,p,0
220492,18,4,3,12,15,f,Fay.jpg,pieFS4.bmp,Fay secretly gambles with her husband's savings.,1,reputation,318006,321059,3053,q,1
220492,19,3,5,11,16,f,Beth.jpg,pieFS3.bmp,Beth claims false expenses for her reportable work travel.,1,reputation,333273,334619,1346,q,1
220492,20,2,6,9,15,m,Daniel.jpg,pieFS2.bmp,Daniel bullies his employees to put in extra hours at work.,1,reputation,346824,348719,1895,q,1
220492,21,5,1,9,10,f,Sharon.jpg,pieFS5.bmp,Sharon works as a cleaner in a hotel,2,na,360908,365219,4311,p,0
220492,22,2,6,9,15,m,Ricky.jpg,pieFS2.bmp,Ricky just lost his job,2,na,377423,378799,1376,q,1
220492,23,4,3,12,15,m,Tony.jpg,pieFS4.bmp,Tony has been unable to find a job for over a year.,2,na,390991,394459,3468,q,1
220492,24,5,2,18,20,m,Michael.jpg,pieFS5.bmp,Michael lost his house in a fire,2,na,406673,408860,2187,q,1
220492,25,4,1,4,5,m,Brad.jpg,pieFS4.bmp,Brad just found $50 on the street,1,resources,421074,423600,2526,p,0
220492,26,3,4,9,13,m,Taymar.jpg,pieFS3.bmp,Taymar employs illegal immigrants and pays them less than minimum wage.,1,reputation,435824,437900,2076,q,1
220492,27,5,1,9,10,f,Miriam.jpg,pieFS5.bmp,Miriam's husband is a wealthy investment banker,1,resources,450108,451880,1772,p,0
220492,28,5,1,9,10,f,Eileen.jpg,pieFS5.bmp,Eileen got a large cash bonus from her boss,1,resources,464092,466840,2748,p,0
220492,29,5,1,9,10,f,Joanna.jpg,pieFS5.bmp,Joanna was a victim of identity theft and is now thousands of dollars in debt.,2,na,479042,484160,5118,q,1
220492,30,5,2,18,20,m,Don.jpg,pieFS5.bmp,Don is homeless,2,na,496373,500100,3727,q,1
220492,31,4,1,4,5,m,Ian.jpg,pieFS4.bmp,Ian is saving to pay his university fees,2,na,512305,515140,2835,p,0
220492,32,3,3,7,10,f,Maria.jpg,pieFS3.bmp,Maria works two waitressing jobs to pay her bills.,2,na,527354,530200,2846,q,1
220492,33,1,10,10,20,f,Janet.jpg,pieFS1.bmp,Janet can't afford to pay her medical bills,2,na,542404,545420,3016,q,1
220492,34,3,2,4,6,f,Arianna.jpg,pieFS3.bmp,Arianna is going to be evicted because she is behind on her rent,2,na,557637,559320,1683,q,1
220492,35,3,2,4,6,f,Jean.jpg,pieFS3.bmp,Jean just received a huge cash settlement,1,resources,571538,574740,3202,p,0
220492,36,3,2,4,6,f,Sammy.jpg,pieFS3.bmp,Sammy takes discarded food from grocery stores to feed her children.,2,na,586954,588360,1406,q,1
220492,37,3,6,14,20,m,Joe.jpg,pieFS3.bmp,Joe could not afford his mortgage and his home was foreclosed.,2,na,600572,602360,1788,q,1
220492,38,4,2,8,10,m,Saul.jpg,pieFS4.bmp,Saul lives in a luxury penthouse apartment,1,resources,614573,617280,2707,p,0
220492,39,3,4,9,13,m,Alan.jpg,pieFS3.bmp,Alan is hiding his taxable income in Switzerland.,1,reputation,629490,631101,1611,q,1
220492,40,3,4,9,13,m,Nick.jpg,pieFS3.bmp,Nick stole money from his mother's wallet.,1,reputation,643341,651800,8459,p,0
220492,41,3,3,7,10,m,George.jpg,pieFS3.bmp,George underreports his company's earnings and pockets the profits.,1,reputation,664034,667081,3047,p,0
220492,42,1,8,8,16,m,Jack.jpg,pieFS1.bmp,Jack lost his life savings when his small business failed,2,na,679300,680421,1121,q,1
220492,43,5,2,18,20,f,Cindy.jpg,pieFS5.bmp,Cindy steals her coworkers' tips to buy alcohol.,1,reputation,692635,694501,1866,p,0
220492,44,5,2,18,20,m,Darnell.jpg,pieFS5.bmp,Darnell cheated on his taxes and is now under investigation for tax fraud.,1,reputation,706719,709141,2422,p,0
220492,45,3,3,7,10,f,Kay.jpg,pieFS3.bmp,Kay owns an international company,1,resources,721336,724181,2845,q,1
220492,46,5,1,9,10,m,Mark.jpg,pieFS5.bmp,Mark is a veteran having trouble finding employment.,2,na,736386,739901,3515,q,1
220492,47,4,2,8,10,f,Deborah.jpg,pieFS4.bmp,Deborah just lost her small business after a franchise moved in next door.,2,na,752102,755321,3219,q,1
220492,48,1,9,9,18,m,Paul.jpg,pieFS1.bmp,Paul is a well paid lawyer,1,resources,767534,769621,2087,q,1
220492,49,4,4,16,20,f,Mary.jpg,pieFS4.bmp,Mary received a large inheritance from a distant relative,1,resources,781835,784681,2846,q,1
220492,50,5,1,9,10,m,Matt.jpg,pieFS5.bmp,Matt stole his elderly father's prescription medications.,1,reputation,796885,798441,1556,p,0
220492,51,5,1,9,10,m,Peter.jpg,pieFS5.bmp,Peter declared bankruptcy after he was laid off.,2,na,810652,814621,3969,p,0
220492,52,4,2,8,10,f,Fiona.jpg,pieFS4.bmp,Fiona is a single mother,2,na,826834,831341,4507,q,1
220503,1,1,8,8,16,m,Brad.jpg,pieFS1.bmp,Brad is saving to pay his university fees,2,na,47966,50681,2715,z,1
220503,2,2,8,12,20,f,Sammy.jpg,pieFS2.bmp,Sammy illegally parks in the disabled parking spots when she can.,1,reputation,62798,65747,2949,m,0
220503,3,5,1,9,10,f,Jackie.jpg,pieFS5.bmp,Jackie's car with her bag and credit cards was recently stolen.,2,na,77863,79026,1163,z,1
220503,4,2,7,10,17,f,Beth.jpg,pieFS2.bmp,Beth is going to be evicted because she is behind on her rent,2,na,91123,92964,1841,z,1
220503,5,3,3,7,10,f,Maria.jpg,pieFS3.bmp,Maria just found out that her husband has incurred a large credit card debt.,2,na,105068,106059,991,z,1
220503,6,1,9,9,18,m,Nick.jpg,pieFS1.bmp,Nick lives in a luxury penthouse apartment,1,resources,118144,119309,1165,z,1
220503,7,5,1,9,10,m,Alan.jpg,pieFS5.bmp,Alan is saving for his son's operation,2,na,131404,132345,941,z,1
220503,8,3,2,4,6,f,Cindy.jpg,pieFS3.bmp,Cindy is a highly paid actress,1,resources,144412,145748,1336,z,1
220503,9,5,2,18,20,m,Don.jpg,pieFS5.bmp,Don stole money from his mother's wallet.,1,reputation,157839,163384,5545,z,1
220503,10,3,3,7,10,f,Mary.jpg,pieFS3.bmp,Mary owns an international company,1,resources,175463,176759,1296,z,1
220503,11,2,6,9,15,m,George.jpg,pieFS2.bmp,George bullies his employees to put in extra hours at work.,1,reputation,188857,189868,1011,z,1
220503,12,5,1,9,10,f,Jean.jpg,pieFS5.bmp,Jean has to take an unpaid leave of absence because her mother broke her hip.,2,na,201966,202730,764,z,1
220503,13,2,3,4,7,m,Ben.jpg,pieFS2.bmp,Ben lost his life savings when his small business failed,2,na,214824,215918,1094,z,1
220503,14,4,2,8,10,m,Saul.jpg,pieFS4.bmp,Saul cheated on his taxes and is now under investigation for tax fraud.,1,reputation,228034,228809,775,z,1
220503,15,3,6,14,20,m,Sam.jpg,pieFS3.bmp,Sam is a veteran having trouble finding employment.,2,na,240909,241981,1072,z,1
220503,16,4,1,4,5,m,Kevin.jpg,pieFS4.bmp,Kevin stole his elderly father's prescription medications.,1,reputation,254068,255209,1141,z,1
220503,17,5,1,9,10,f,Lauren.jpg,pieFS5.bmp,Lauren got a large cash bonus from her boss,1,resources,267277,269545,2268,z,1
220503,18,5,2,18,20,m,Daniel.jpg,pieFS5.bmp,Daniel just lost his job,2,na,281624,283015,1391,z,1
220503,19,3,2,4,6,f,Eileen.jpg,pieFS3.bmp,Eileen was a victim of identity theft and is now thousands of dollars in debt.,2,na,295101,296047,946,z,1
220503,20,4,2,8,10,m,Paul.jpg,pieFS4.bmp,Paul employs illegal immigrants and pays them less than minimum wage.,1,reputation,308143,309113,970,z,1
220503,21,4,2,8,10,f,Monica.jpg,pieFS4.bmp,Monica works two waitressing jobs to pay her bills.,2,na,321202,322048,846,z,1
220503,22,4,4,16,20,f,Deborah.jpg,pieFS4.bmp,Deborah just received a huge cash settlement,1,resources,334144,335267,1123,z,1
220503,23,2,3,4,7,f,Kay.jpg,pieFS2.bmp,Kay received a large inheritance from a distant relative,1,resources,347354,348393,1039,z,1
220503,24,1,10,10,20,f,Miriam.jpg,pieFS1.bmp,Miriam is a single mother,2,na,360463,361583,1120,z,1
220503,25,4,2,8,10,f,Jenny.jpg,pieFS4.bmp,Jenny takes discarded food from grocery stores to feed her children.,2,na,373672,374736,1064,z,1
220503,26,3,6,14,20,m,Ricky.jpg,pieFS3.bmp,Ricky could not afford his mortgage and his home was foreclosed.,2,na,386832,387857,1025,z,1
220503,27,4,4,16,20,f,Joanna.jpg,pieFS4.bmp,Joanna steals her coworkers' tips to buy alcohol.,1,reputation,399958,401936,1978,z,1
220503,28,4,1,4,5,m,Peter.jpg,pieFS4.bmp,Peter declared bankruptcy after he was laid off.,2,na,414020,415186,1166,z,1
220503,29,4,3,12,15,f,Trish.jpg,pieFS4.bmp,Trish just won the lottery,1,resources,427280,427665,385,z,1
220503,30,3,3,7,10,m,Jared.jpg,pieFS3.bmp,Jared is hiding his taxable income in Switzerland.,1,reputation,439753,440969,1216,z,1
220503,31,4,3,12,15,m,Ian.jpg,pieFS4.bmp,Ian takes valuables from his friends' homes when asked to house-sit.,1,reputation,453063,454282,1219,z,1
220503,32,3,4,9,13,m,Joe.jpg,pieFS3.bmp,Joe underreports his company's earnings and pockets the profits.,1,reputation,466373,467314,941,z,1
220503,33,2,6,9,15,m,Darnell.jpg,pieFS2.bmp,Darnell was injured in a hit-and-run accident and cannot afford his medical bills.,2,na,479399,480471,1072,z,1
220503,34,4,3,12,15,f,Janet.jpg,pieFS4.bmp,Janet cannot afford to send her son to college.,2,na,492558,493475,917,z,1
220503,35,3,2,4,6,f,Marny.jpg,pieFS3.bmp,Marny just lost her small business after a franchise moved in next door.,2,na,505567,506535,968,z,1
220503,36,5,1,9,10,f,Arianna.jpg,pieFS5.bmp,Arianna regularly fires employees to avoid promoting them.,1,reputation,518626,521801,3175,m,0
220503,37,3,5,11,16,f,Fay.jpg,pieFS3.bmp,Fay secretly gambles with her husband's savings.,1,reputation,533892,534583,691,z,1
220503,38,5,2,18,20,f,Kelly.jpg,pieFS5.bmp,Kelly used her mother's social security number to open a credit card account.,1,reputation,546684,547867,1183,z,1
220503,39,5,1,9,10,m,Taymar.jpg,pieFS5.bmp,Taymar is a well paid lawyer,1,resources,559960,561100,1140,z,1
220503,40,5,2,18,20,m,Jack.jpg,pieFS5.bmp,Jack was mugged and had his wallet stolen.,2,na,573169,574648,1479,z,1
220503,41,1,5,5,10,f,Fiona.jpg,pieFS1.bmp,Fiona claims false expenses for her reportable work travel.,1,reputation,586747,588039,1292,z,1
220503,42,4,1,4,5,f,Emily.jpg,pieFS4.bmp,Emily is raising money to buy gifts for children in need.,2,na,600124,600946,822,z,1
220503,43,3,4,9,13,m,Michael.jpg,pieFS3.bmp,Michael often goes through and steals the neighbors' mail.,1,reputation,613032,614108,1076,z,1
220503,44,3,5,11,16,m,Mark.jpg,pieFS3.bmp,Mark has been unable to find a job for over a year.,2,na,626208,627307,1099,z,1
220503,45,5,1,9,10,m,Edward.jpg,pieFS5.bmp,Edward is a retiree,2,na,639384,640511,1127,z,1
220503,46,5,1,9,10,f,Louise.jpg,pieFS5.bmp,Louise works as a cleaner in a hotel,2,na,652610,653589,979,z,1
220503,47,5,2,18,20,m,Justin.jpg,pieFS5.bmp,Justin just bought an expensive sports car,1,resources,665669,666850,1181,z,1
220503,48,5,1,9,10,f,Sharon.jpg,pieFS5.bmp,Sharon's husband is a wealthy investment banker,1,resources,678946,679674,728,z,1
220503,49,4,4,16,20,m,Tony.jpg,pieFS4.bmp,Tony lost his house in a fire,2,na,691771,692857,1086,z,1
220503,50,3,4,9,13,m,Matt.jpg,pieFS3.bmp,Matt just found $50 on the street,1,resources,704947,706311,1364,z,1
220503,51,4,3,12,15,m,Stuart.jpg,pieFS4.bmp,Stuart is homeless,2,na,718390,719296,906,z,1
220503,52,3,2,4,6,f,Emma.jpg,pieFS3.bmp,Emma can't afford to pay her medical bills,2,na,731382,732248,866,z,1
220523,1,4,3,12,15,m,Joe.jpg,pieFS4.bmp,Joe just bought an expensive sports car,1,resources,38421,40724,2303,m,0
220523,2,5,2,18,20,m,Edward.jpg,pieFS5.bmp,Edward is saving for his son's operation,2,na,52834,55273,2439,m,0
220523,3,3,2,4,6,f,Monica.jpg,pieFS3.bmp,Monica's car with her bag and credit cards was recently stolen.,2,na,67382,72743,5361,z,1
220523,4,4,2,8,10,f,Janet.jpg,pieFS4.bmp,Janet can't afford to pay her medical bills,2,na,84821,87353,2532,m,0
220523,5,3,4,9,13,m,Ricky.jpg,pieFS3.bmp,Ricky bullies his employees to put in extra hours at work.,1,reputation,99452,103178,3726,m,0
220523,6,1,8,8,16,m,Michael.jpg,pieFS1.bmp,Michael declared bankruptcy after he was laid off.,2,na,115270,118198,2928,z,1
220523,7,3,4,9,13,m,Peter.jpg,pieFS3.bmp,Peter takes valuables from his friends' homes when asked to house-sit.,1,reputation,130286,133074,2788,m,0
220523,8,3,2,4,6,f,Miriam.jpg,pieFS3.bmp,Miriam is going to be evicted because she is behind on her rent,2,na,145150,149934,4784,z,1
220523,9,4,1,4,5,f,Maria.jpg,pieFS4.bmp,Maria just found out that her husband has incurred a large credit card debt.,2,na,162022,165089,3067,m,0
220523,10,2,8,12,20,f,Beth.jpg,pieFS2.bmp,Beth owns an international company,1,resources,177188,180389,3201,z,1
220523,11,5,2,18,20,m,Jared.jpg,pieFS5.bmp,Jared just lost his job,2,na,192487,194656,2169,m,0
220523,12,3,5,11,16,f,Mary.jpg,pieFS3.bmp,Mary received a large inheritance from a distant relative,1,resources,206750,209875,3125,z,1
220523,13,5,1,9,10,m,Ian.jpg,pieFS5.bmp,Ian was injured in a hit-and-run accident and cannot afford his medical bills.,2,na,221966,224280,2314,m,0
220523,14,5,1,9,10,f,Sharon.jpg,pieFS5.bmp,Sharon is a single mother,2,na,236363,238314,1951,m,0
220523,15,4,4,16,20,f,Emily.jpg,pieFS4.bmp,Emily is a highly paid actress,1,resources,250409,252768,2359,m,0
220523,16,4,2,8,10,m,Taymar.jpg,pieFS4.bmp,Taymar employs illegal immigrants and pays them less than minimum wage.,1,reputation,264855,267159,2304,m,0
220523,17,3,6,14,20,m,George.jpg,pieFS3.bmp,George could not afford his mortgage and his home was foreclosed.,2,na,279252,281879,2627,m,0
220523,18,2,6,9,15,m,Daniel.jpg,pieFS2.bmp,Daniel is hiding his taxable income in Switzerland.,1,reputation,293966,296708,2742,z,1
220523,19,2,6,9,15,m,Matt.jpg,pieFS2.bmp,Matt was mugged and had his wallet stolen.,2,na,308798,312037,3239,m,0
220523,20,5,1,9,10,f,Lauren.jpg,pieFS5.bmp,Lauren has to take an unpaid leave of absence because her mother broke her hip.,2,na,324131,326678,2547,m,0
220523,21,4,4,16,20,f,Trish.jpg,pieFS4.bmp,Trish just won the lottery,1,resources,338779,341220,2441,m,0
220523,22,5,1,9,10,m,Nick.jpg,pieFS5.bmp,Nick often goes through and steals the neighbors' mail.,1,reputation,353309,355633,2324,m,0
220523,23,3,3,7,10,f,Arianna.jpg,pieFS3.bmp,Arianna cannot afford to send her son to college.,2,na,367739,370727,2988,m,0
220523,24,5,1,9,10,m,Saul.jpg,pieFS5.bmp,Saul has been unable to find a job for over a year.,2,na,382821,384775,1954,m,0
220523,25,2,3,4,7,m,Brad.jpg,pieFS2.bmp,Brad lost his house in a fire,2,na,396850,399457,2607,z,1
220523,26,4,2,8,10,m,Paul.jpg,pieFS4.bmp,Paul underreports his company's earnings and pockets the profits.,1,reputation,411548,413855,2307,m,0
220523,27,1,9,9,18,m,Darnell.jpg,pieFS1.bmp,Darnell just found $50 on the street,1,resources,425945,428527,2582,z,1
220523,28,5,1,9,10,f,Emma.jpg,pieFS5.bmp,Emma regularly fires employees to avoid promoting them.,1,reputation,440625,442731,2106,m,0
220523,29,3,3,7,10,f,Kelly.jpg,pieFS3.bmp,Kelly got a large cash bonus from her boss,1,resources,454822,457435,2613,m,0
220523,30,4,2,8,10,f,Jean.jpg,pieFS4.bmp,Jean was a victim of identity theft and is now thousands of dollars in debt.,2,na,469519,472045,2526,m,0
220523,31,1,10,10,20,f,Joanna.jpg,pieFS1.bmp,Joanna works two waitressing jobs to pay her bills.,2,na,484133,486562,2429,z,1
220523,32,4,3,12,15,f,Jenny.jpg,pieFS4.bmp,Jenny just received a huge cash settlement,1,resources,498630,500859,2229,m,0
220523,33,2,7,10,17,f,Deborah.jpg,pieFS2.bmp,Deborah takes discarded food from grocery stores to feed her children.,2,na,512943,515643,2700,z,1
220523,34,5,1,9,10,f,Fay.jpg,pieFS5.bmp,Fay secretly gambles with her husband's savings.,1,reputation,527741,529910,2169,m,0
220523,35,5,1,9,10,f,Eileen.jpg,pieFS5.bmp,Eileen steals her coworkers' tips to buy alcohol.,1,reputation,542004,543801,1797,m,0
220523,36,4,1,4,5,m,Kevin.jpg,pieFS4.bmp,Kevin is homeless,2,na,555883,557942,2059,m,0
220523,37,3,4,9,13,m,Alan.jpg,pieFS3.bmp,Alan is a well paid lawyer,1,resources,570029,572318,2289,m,0
220523,38,3,6,14,20,m,Justin.jpg,pieFS3.bmp,Justin is a retiree,2,na,584409,587305,2896,m,0
220523,39,3,5,11,16,m,Sam.jpg,pieFS3.bmp,Sam is saving to pay his university fees,2,na,599390,602210,2820,m,0
220523,40,5,1,9,10,f,Jackie.jpg,pieFS5.bmp,Jackie just lost her small business after a franchise moved in next door.,2,na,614305,617055,2750,m,0
220523,41,3,2,4,6,f,Louise.jpg,pieFS3.bmp,Louise claims false expenses for her reportable work travel.,1,reputation,629154,633806,4652,m,0
220523,42,3,3,7,10,m,Jack.jpg,pieFS3.bmp,Jack lives in a luxury penthouse apartment,1,resources,645875,648090,2215,m,0
220523,43,5,2,18,20,m,Mark.jpg,pieFS5.bmp,Mark stole money from his mother's wallet.,1,reputation,660188,662073,1885,m,0
220523,44,5,2,18,20,f,Cindy.jpg,pieFS5.bmp,Cindy used her mother's social security number to open a credit card account.,1,reputation,674166,676058,1892,m,0
220523,45,3,2,4,6,f,Marny.jpg,pieFS3.bmp,Marny is raising money to buy gifts for children in need.,2,na,688145,690621,2476,z,1
220523,46,4,4,16,20,m,Ben.jpg,pieFS4.bmp,Ben lost his life savings when his small business failed,2,na,702709,704938,2229,m,0
220523,47,2,3,4,7,f,Sammy.jpg,pieFS2.bmp,Sammy illegally parks in the disabled parking spots when she can.,1,reputation,717039,719967,2928,z,1
220523,48,4,3,12,15,f,Kay.jpg,pieFS4.bmp,Kay works as a cleaner in a hotel,2,na,732037,734217,2180,m,0
220523,49,4,1,4,5,m,Don.jpg,pieFS4.bmp,Don cheated on his taxes and is now under investigation for tax fraud.,1,reputation,746317,748640,2323,m,0
220523,50,4,3,12,15,m,Tony.jpg,pieFS4.bmp,Tony is a veteran having trouble finding employment.,2,na,760730,763398,2668,m,0
220523,51,1,5,5,10,f,Fiona.jpg,pieFS1.bmp,Fiona's husband is a wealthy investment banker,1,resources,775478,777876,2398,z,1
220523,52,5,2,18,20,m,Stuart.jpg,pieFS5.bmp,Stuart stole his elderly father's prescription medications.,1,reputation,789959,791985,2026,m,0
220531,1,5,1,9,10,f,Kelly.jpg,pieFS5.bmp,Kelly takes discarded food from grocery stores to feed her children.,2,na,51775,55936,4161,q,1
220531,2,5,1,9,10,m,Matt.jpg,pieFS5.bmp,Matt is homeless,2,na,68190,73537,5347,p,0
220531,3,3,4,9,13,m,Taymar.jpg,pieFS3.bmp,Taymar is a well paid lawyer,1,resources,85904,89097,3193,q,1
220531,4,3,2,4,6,f,Monica.jpg,pieFS3.bmp,Monica steals her coworkers' tips to buy alcohol.,1,reputation,101370,103937,2567,p,0
220531,5,4,2,8,10,f,Joanna.jpg,pieFS4.bmp,Joanna just lost her small business after a franchise moved in next door.,2,na,116237,120037,3800,p,0
220531,6,2,3,4,7,f,Kay.jpg,pieFS2.bmp,Kay secretly gambles with her husband's savings.,1,reputation,132403,134718,2315,q,1
220531,7,5,1,9,10,f,Louise.jpg,pieFS5.bmp,Louise claims false expenses for her reportable work travel.,1,reputation,147003,149278,2275,p,0
220531,8,4,3,12,15,m,Alan.jpg,pieFS4.bmp,Alan is a retiree,2,na,161554,164659,3105,q,1
220531,9,4,4,16,20,f,Eileen.jpg,pieFS4.bmp,Eileen used her mother's social security number to open a credit card account.,1,reputation,176937,180299,3362,p,0
220531,10,3,3,7,10,f,Sammy.jpg,pieFS3.bmp,Sammy is raising money to buy gifts for children in need.,2,na,192587,194860,2273,q,1
220531,11,5,2,18,20,m,Stuart.jpg,pieFS5.bmp,Stuart is saving to pay his university fees,2,na,207154,208560,1406,p,0
220531,12,4,2,8,10,m,Ricky.jpg,pieFS4.bmp,Ricky just bought an expensive sports car,1,resources,220822,222440,1618,p,0
220531,13,1,9,9,18,m,Darnell.jpg,pieFS1.bmp,Darnell lives in a luxury penthouse apartment,1,resources,234707,238241,3534,q,1
220531,14,3,4,9,13,m,Mark.jpg,pieFS3.bmp,Mark stole money from his mother's wallet.,1,reputation,250523,254501,3978,q,1
220531,15,2,3,4,7,m,Kevin.jpg,pieFS2.bmp,Kevin lost his life savings when his small business failed,2,na,266771,268541,1770,q,1
220531,16,4,1,4,5,m,Peter.jpg,pieFS4.bmp,Peter cheated on his taxes and is now under investigation for tax fraud.,1,reputation,280839,282642,1803,p,0
220531,17,2,8,12,20,f,Deborah.jpg,pieFS2.bmp,Deborah illegally parks in the disabled parking spots when she can.,1,reputation,294924,298782,3858,p,0
220531,18,1,10,10,20,f,Trish.jpg,pieFS1.bmp,Trish works as a cleaner in a hotel,2,na,311039,313663,2624,q,1
220531,19,3,5,11,16,m,Justin.jpg,pieFS3.bmp,Justin is saving for his son's operation,2,na,325940,327983,2043,q,1
220531,20,5,1,9,10,f,Sharon.jpg,pieFS5.bmp,Sharon's husband is a wealthy investment banker,1,resources,340257,341663,1406,p,0
220531,21,3,2,4,6,f,Fay.jpg,pieFS3.bmp,Fay can't afford to pay her medical bills,2,na,353942,355944,2002,q,1
220531,22,4,3,12,15,f,Mary.jpg,pieFS4.bmp,Mary is going to be evicted because she is behind on her rent,2,na,368210,371604,3394,q,1
220531,23,5,1,9,10,m,Joe.jpg,pieFS5.bmp,Joe bullies his employees to put in extra hours at work.,1,reputation,383876,386184,2308,p,0
220531,24,4,2,8,10,f,Jenny.jpg,pieFS4.bmp,Jenny's car with her bag and credit cards was recently stolen.,2,na,398460,401425,2965,p,0
220531,25,3,2,4,6,f,Lauren.jpg,pieFS3.bmp,Lauren just found out that her husband has incurred a large credit card debt.,2,na,413693,416765,3072,q,1
220531,26,5,2,18,20,f,Miriam.jpg,pieFS5.bmp,Miriam owns an international company,1,resources,429043,431566,2523,p,0
220531,27,4,4,16,20,f,Janet.jpg,pieFS4.bmp,Janet received a large inheritance from a distant relative,1,resources,443843,447226,3383,p,0
220531,28,5,1,9,10,m,Michael.jpg,pieFS5.bmp,Michael is a veteran having trouble finding employment.,2,na,459492,460646,1154,q,1
220531,29,4,3,12,15,f,Maria.jpg,pieFS4.bmp,Maria is a highly paid actress,1,resources,472928,474847,1919,p,0
220531,30,5,2,18,20,m,Don.jpg,pieFS5.bmp,Don stole his elderly father's prescription medications.,1,reputation,487129,488987,1858,p,0
220531,31,3,2,4,6,f,Emma.jpg,pieFS3.bmp,Emma is a single mother,2,na,501246,503328,2082,q,1
220531,32,4,1,4,5,m,Brad.jpg,pieFS4.bmp,Brad declared bankruptcy after he was laid off.,2,na,515597,517928,2331,q,1
220531,33,1,8,8,16,m,George.jpg,pieFS1.bmp,George just lost his job,2,na,530181,532348,2167,q,1
220531,34,2,6,9,15,m,Edward.jpg,pieFS2.bmp,Edward employs illegal immigrants and pays them less than minimum wage.,1,reputation,544632,546609,1977,q,1
220531,35,5,2,18,20,m,Jared.jpg,pieFS5.bmp,Jared could not afford his mortgage and his home was foreclosed.,2,na,558883,561269,2386,q,1
220531,36,5,1,9,10,f,Jean.jpg,pieFS5.bmp,Jean has to take an unpaid leave of absence because her mother broke her hip.,2,na,573533,574809,1276,q,1
220531,37,3,3,7,10,f,Jackie.jpg,pieFS3.bmp,Jackie got a large cash bonus from her boss,1,resources,587102,588430,1328,q,1
220531,38,3,4,9,13,m,Paul.jpg,pieFS3.bmp,Paul is hiding his taxable income in Switzerland.,1,reputation,600703,603810,3107,q,1
220531,39,4,3,12,15,m,Nick.jpg,pieFS4.bmp,Nick takes valuables from his friends' homes when asked to house-sit.,1,reputation,616086,618611,2525,p,0
220531,40,4,2,8,10,m,Daniel.jpg,pieFS4.bmp,Daniel underreports his company's earnings and pockets the profits.,1,reputation,630887,632051,1164,p,0
220531,41,1,5,5,10,f,Fiona.jpg,pieFS1.bmp,Fiona just won the lottery,1,resources,644322,647351,3029,q,1
220531,42,3,6,14,20,m,Tony.jpg,pieFS3.bmp,Tony was injured in a hit-and-run accident and cannot afford his medical bills.,2,na,659638,661392,1754,q,1
220531,43,5,1,9,10,f,Emily.jpg,pieFS5.bmp,Emily was a victim of identity theft and is now thousands of dollars in debt.,2,na,673723,676172,2449,q,1
220531,44,4,4,16,20,m,Saul.jpg,pieFS4.bmp,Saul was mugged and had his wallet stolen.,2,na,688423,690792,2369,p,0
220531,45,4,1,4,5,f,Cindy.jpg,pieFS4.bmp,Cindy works two waitressing jobs to pay her bills.,2,na,703057,704053,996,q,1
220531,46,3,3,7,10,m,Sam.jpg,pieFS3.bmp,Sam often goes through and steals the neighbors' mail.,1,reputation,716326,721013,4687,p,0
220531,47,2,6,9,15,m,Ben.jpg,pieFS2.bmp,Ben has been unable to find a job for over a year.,2,na,733274,736514,3240,q,1
220531,48,2,7,10,17,f,Beth.jpg,pieFS2.bmp,Beth cannot afford to send her son to college.,2,na,748790,750934,2144,q,1
220531,49,5,1,9,10,f,Arianna.jpg,pieFS5.bmp,Arianna regularly fires employees to avoid promoting them.,1,reputation,763208,765715,2507,p,0
220531,50,3,5,11,16,f,Marny.jpg,pieFS3.bmp,Marny just received a huge cash settlement,1,resources,777991,781155,3164,q,1
220531,51,3,6,14,20,m,Ian.jpg,pieFS3.bmp,Ian lost his house in a fire,2,na,793408,795835,2427,q,1
220531,52,5,2,18,20,m,Jack.jpg,pieFS5.bmp,Jack just found $50 on the street,1,resources,808108,811776,3668,p,0
220553,1,2,8,12,20,f,Kay.jpg,pieFS2.bmp,Kay just won the lottery,1,resources,38759,40334,1575,q,1
220553,2,5,1,9,10,f,Arianna.jpg,pieFS5.bmp,Arianna cannot afford to send her son to college.,2,na,52577,55174,2597,q,1
220553,3,3,6,14,20,m,Taymar.jpg,pieFS3.bmp,Taymar just lost his job,2,na,67411,68855,1444,q,1
220553,4,4,3,12,15,f,Cindy.jpg,pieFS4.bmp,Cindy steals her coworkers' tips to buy alcohol.,1,reputation,81096,82615,1519,p,0
220553,5,3,2,4,6,f,Sammy.jpg,pieFS3.bmp,Sammy just lost her small business after a franchise moved in next door.,2,na,94864,95995,1131,q,1
220553,6,3,3,7,10,m,Jack.jpg,pieFS3.bmp,Jack cheated on his taxes and is now under investigation for tax fraud.,1,reputation,108249,110316,2067,p,0
220553,7,5,2,18,20,m,Joe.jpg,pieFS5.bmp,Joe employs illegal immigrants and pays them less than minimum wage.,1,reputation,122550,123676,1126,p,0
220553,8,1,5,5,10,f,Joanna.jpg,pieFS1.bmp,Joanna used her mother's social security number to open a credit card account.,1,reputation,135902,141617,5715,q,1
220553,9,5,2,18,20,m,Don.jpg,pieFS5.bmp,Don is a veteran having trouble finding employment.,2,na,153833,157037,3204,q,1
220553,10,3,2,4,6,f,Sharon.jpg,pieFS3.bmp,Sharon regularly fires employees to avoid promoting them.,1,reputation,169249,170317,1068,p,0
220553,11,2,6,9,15,m,Ian.jpg,pieFS2.bmp,Ian stole his elderly father's prescription medications.,1,reputation,182534,183658,1124,p,0
220553,12,4,3,12,15,f,Eileen.jpg,pieFS4.bmp,Eileen is raising money to buy gifts for children in need.,2,na,195853,196758,905,q,1
220553,13,3,5,11,16,f,Jean.jpg,pieFS3.bmp,Jean illegally parks in the disabled parking spots when she can.,1,reputation,208972,213078,4106,q,1
220553,14,5,1,9,10,f,Lauren.jpg,pieFS5.bmp,Lauren's car with her bag and credit cards was recently stolen.,2,na,225287,226919,1632,q,1
220553,15,1,8,8,16,m,Sam.jpg,pieFS1.bmp,Sam declared bankruptcy after he was laid off.,2,na,239122,240099,977,q,1
220553,16,5,2,18,20,m,Paul.jpg,pieFS5.bmp,Paul could not afford his mortgage and his home was foreclosed.,2,na,252307,253520,1213,q,1
220553,17,3,3,7,10,f,Jackie.jpg,pieFS3.bmp,Jackie just found out that her husband has incurred a large credit card debt.,2,na,265743,266820,1077,q,1
220553,18,3,3,7,10,f,Mary.jpg,pieFS3.bmp,Mary secretly gambles with her husband's savings.,1,reputation,279061,279901,840,p,0
220553,19,2,3,4,7,f,Trish.jpg,pieFS2.bmp,Trish claims false expenses for her reportable work travel.,1,reputation,292113,293820,1707,p,0
220553,20,4,2,8,10,m,Tony.jpg,pieFS4.bmp,Tony takes valuables from his friends' homes when asked to house-sit.,1,reputation,306031,306701,670,p,0
220553,21,5,1,9,10,f,Monica.jpg,pieFS5.bmp,Monica is a highly paid actress,1,resources,318917,320962,2045,q,1
220553,22,4,2,8,10,m,George.jpg,pieFS4.bmp,George is hiding his taxable income in Switzerland.,1,reputation,333168,334502,1334,p,0
220553,23,3,5,11,16,m,Stuart.jpg,pieFS3.bmp,Stuart was injured in a hit-and-run accident and cannot afford his medical bills.,2,na,346703,347802,1099,q,1
220553,24,5,1,9,10,m,Nick.jpg,pieFS5.bmp,Nick was mugged and had his wallet stolen.,2,na,360005,361162,1157,q,1
220553,25,3,4,9,13,m,Mark.jpg,pieFS3.bmp,Mark often goes through and steals the neighbors' mail.,1,reputation,373374,374803,1429,p,0
220553,26,3,2,4,6,f,Fay.jpg,pieFS3.bmp,Fay works as a cleaner in a hotel,2,na,386992,387963,971,q,1
220553,27,4,1,4,5,m,Jared.jpg,pieFS4.bmp,Jared underreports his company's earnings and pockets the profits.,1,reputation,400178,401723,1545,p,0
220553,28,4,4,16,20,m,Matt.jpg,pieFS4.bmp,Matt has been unable to find a job for over a year.,2,na,413929,415004,1075,q,1
220553,29,1,9,9,18,m,Edward.jpg,pieFS1.bmp,Edward is a well paid lawyer,1,resources,427215,428224,1009,q,1
220553,30,5,2,18,20,f,Emma.jpg,pieFS5.bmp,Emma's husband is a wealthy investment banker,1,resources,440433,441444,1011,q,1
220553,31,4,1,4,5,f,Maria.jpg,pieFS4.bmp,Maria has to take an unpaid leave of absence because her mother broke her hip.,2,na,453652,454585,933,q,1
220553,32,5,1,9,10,m,Michael.jpg,pieFS5.bmp,Michael lost his house in a fire,2,na,466788,468605,1817,q,1
220553,33,3,4,9,13,m,Brad.jpg,pieFS3.bmp,Brad just found $50 on the street,1,resources,480806,481605,799,q,1
220553,34,5,1,9,10,f,Miriam.jpg,pieFS5.bmp,Miriam can't afford to pay her medical bills,2,na,493808,495506,1698,q,1
220553,35,4,4,16,20,f,Emily.jpg,pieFS4.bmp,Emily got a large cash bonus from her boss,1,resources,507709,508526,817,q,1
220553,36,2,6,9,15,m,Alan.jpg,pieFS2.bmp,Alan is a retiree,2,na,520695,521506,811,q,1
220553,37,4,1,4,5,m,Ben.jpg,pieFS4.bmp,Ben is homeless,2,na,533714,534867,1153,q,1
220553,38,4,2,8,10,f,Fiona.jpg,pieFS4.bmp,Fiona is going to be evicted because she is behind on her rent,2,na,547082,547947,865,q,1
220553,39,4,3,12,15,m,Darnell.jpg,pieFS4.bmp,Darnell is saving to pay his university fees,2,na,560151,561007,856,q,1
220553,40,3,2,4,6,f,Jenny.jpg,pieFS3.bmp,Jenny was a victim of identity theft and is now thousands of dollars in debt.,2,na,573237,574108,871,q,1
220553,41,3,4,9,13,m,Kevin.jpg,pieFS3.bmp,Kevin lives in a luxury penthouse apartment,1,resources,586339,587448,1109,q,1
220553,42,4,4,16,20,f,Janet.jpg,pieFS4.bmp,Janet owns an international company,1,resources,599674,600628,954,q,1
220553,43,4,2,8,10,f,Deborah.jpg,pieFS4.bmp,Deborah works two waitressing jobs to pay her bills.,2,na,612843,613729,886,q,1
220553,44,5,2,18,20,m,Daniel.jpg,pieFS5.bmp,Daniel just bought an expensive sports car,1,resources,625946,626949,1003,p,0
220553,45,5,1,9,10,f,Kelly.jpg,pieFS5.bmp,Kelly just received a huge cash settlement,1,resources,639148,641690,2542,q,1
220553,46,5,1,9,10,f,Louise.jpg,pieFS5.bmp,Louise received a large inheritance from a distant relative,1,resources,653898,655910,2012,p,0
220553,47,2,3,4,7,m,Justin.jpg,pieFS2.bmp,Justin is saving for his son's operation,2,na,668099,669030,931,q,1
220553,48,5,1,9,10,m,Ricky.jpg,pieFS5.bmp,Ricky bullies his employees to put in extra hours at work.,1,reputation,681235,682291,1056,p,0
220553,49,1,10,10,20,f,Marny.jpg,pieFS1.bmp,Marny takes discarded food from grocery stores to feed her children.,2,na,694503,695451,948,q,1
220553,50,2,7,10,17,f,Beth.jpg,pieFS2.bmp,Beth is a single mother,2,na,707655,708851,1196,q,1
220553,51,4,3,12,15,m,Peter.jpg,pieFS4.bmp,Peter stole money from his mother's wallet.,1,reputation,721057,721852,795,p,0
220553,52,3,6,14,20,m,Saul.jpg,pieFS3.bmp,Saul lost his life savings when his small business failed,2,na,734060,734872,812,q,1
220566,1,5,1,9,10,f,Arianna.jpg,pieFS5.bmp,Arianna is going to be evicted because she is behind on her rent,2,na,89041,94912,5871,z,1
220566,2,4,4,16,20,m,Kevin.jpg,pieFS4.bmp,Kevin has been unable to find a job for over a year.,2,na,107016,114129,7113,z,1
220566,3,4,3,12,15,f,Fiona.jpg,pieFS4.bmp,Fiona owns an international company,1,resources,126229,142604,16375,z,1
220566,4,3,2,4,6,f,Cindy.jpg,pieFS3.bmp,Cindy steals her coworkers' tips to buy alcohol.,1,reputation,154721,166270,11549,z,1
220566,5,3,2,4,6,f,Marny.jpg,pieFS3.bmp,Marny just lost her small business after a franchise moved in next door.,2,na,178364,181608,3244,z,1
220566,6,5,2,18,20,m,Edward.jpg,pieFS5.bmp,Edward just lost his job,2,na,193697,196040,2343,z,1
220566,7,3,5,11,16,f,Janet.jpg,pieFS3.bmp,Janet received a large inheritance from a distant relative,1,resources,208128,209881,1753,z,1
220566,8,4,2,8,10,f,Sharon.jpg,pieFS4.bmp,Sharon is a single mother,2,na,221972,223737,1765,z,1
220566,9,3,5,11,16,m,Brad.jpg,pieFS3.bmp,Brad lost his house in a fire,2,na,235817,236993,1176,z,1
220566,10,3,4,9,13,m,Don.jpg,pieFS3.bmp,Don just found $50 on the street,1,resources,249094,251561,2467,z,1
220566,11,4,4,16,20,f,Miriam.jpg,pieFS4.bmp,Miriam just won the lottery,1,resources,263658,266841,3183,z,1
220566,12,3,3,7,10,f,Beth.jpg,pieFS3.bmp,Beth cannot afford to send her son to college.,2,na,278941,282142,3201,z,1
220566,13,3,4,9,13,m,Ricky.jpg,pieFS3.bmp,Ricky employs illegal immigrants and pays them less than minimum wage.,1,reputation,294240,308597,14357,z,1
220566,14,4,1,4,5,m,Jack.jpg,pieFS4.bmp,Jack is homeless,2,na,320693,322917,2224,z,1
220566,15,2,3,4,7,m,Nick.jpg,pieFS2.bmp,Nick is saving to pay his university fees,2,na,335022,336646,1624,z,1
220566,16,2,3,4,7,f,Deborah.jpg,pieFS2.bmp,Deborah used her mother's social security number to open a credit card account.,1,reputation,348734,357008,8274,z,1
220566,17,5,1,9,10,m,Saul.jpg,pieFS5.bmp,Saul lives in a luxury penthouse apartment,1,resources,369100,373019,3919,z,1
220566,18,4,3,12,15,m,Taymar.jpg,pieFS4.bmp,Taymar could not afford his mortgage and his home was foreclosed.,2,na,385118,386444,1326,z,1
220566,19,4,2,8,10,m,Jared.jpg,pieFS4.bmp,Jared is hiding his taxable income in Switzerland.,1,reputation,398528,402456,3928,z,1
220566,20,5,2,18,20,m,Matt.jpg,pieFS5.bmp,Matt stole money from his mother's wallet.,1,reputation,414547,418074,3527,z,1
220566,21,2,8,12,20,f,Emma.jpg,pieFS2.bmp,Emma regularly fires employees to avoid promoting them.,1,reputation,430164,456978,26814,m,0
220566,22,5,1,9,10,f,Emily.jpg,pieFS5.bmp,Emily is raising money to buy gifts for children in need.,2,na,469091,471022,1931,z,1
220566,23,1,9,9,18,m,Justin.jpg,pieFS1.bmp,Justin underreports his company's earnings and pockets the profits.,1,reputation,483136,505539,22403,z,1
220566,24,5,2,18,20,m,Joe.jpg,pieFS5.bmp,Joe is a well paid lawyer,1,resources,517631,520408,2777,z,1
220566,25,4,4,16,20,f,Sammy.jpg,pieFS4.bmp,Sammy illegally parks in the disabled parking spots when she can.,1,reputation,532496,538669,6173,z,1
220566,26,2,7,10,17,f,Jackie.jpg,pieFS2.bmp,Jackie's car with her bag and credit cards was recently stolen.,2,na,550755,552169,1414,z,1
220566,27,3,6,14,20,m,Peter.jpg,pieFS3.bmp,Peter lost his life savings when his small business failed,2,na,564266,565351,1085,z,1
220566,28,3,2,4,6,f,Eileen.jpg,pieFS3.bmp,Eileen just found out that her husband has incurred a large credit card debt.,2,na,577442,579693,2251,z,1
220566,29,5,1,9,10,f,Jenny.jpg,pieFS5.bmp,Jenny is a highly paid actress,1,resources,591789,593174,1385,z,1
220566,30,4,3,12,15,m,Ben.jpg,pieFS4.bmp,Ben cheated on his taxes and is now under investigation for tax fraud.,1,reputation,605266,611211,5945,z,1
220566,31,3,3,7,10,f,Trish.jpg,pieFS3.bmp,Trish secretly gambles with her husband's savings.,1,reputation,623307,624054,747,z,1
220566,32,1,8,8,16,m,Mark.jpg,pieFS1.bmp,Mark is a veteran having trouble finding employment.,2,na,636149,637816,1667,z,1
220566,33,4,2,8,10,f,Lauren.jpg,pieFS4.bmp,Lauren has to take an unpaid leave of absence because her mother broke her hip.,2,na,649927,652028,2101,z,1
220566,34,5,2,18,20,f,Joanna.jpg,pieFS5.bmp,Joanna got a large cash bonus from her boss,1,resources,664140,666090,1950,z,1
220566,35,3,3,7,10,m,Michael.jpg,pieFS3.bmp,Michael stole his elderly father's prescription medications.,1,reputation,678185,679173,988,z,1
220566,36,5,1,9,10,m,Daniel.jpg,pieFS5.bmp,Daniel is a retiree,2,na,691261,693145,1884,z,1
220566,37,4,2,8,10,m,George.jpg,pieFS4.bmp,George just bought an expensive sports car,1,resources,705240,707001,1761,z,1
220566,38,2,6,9,15,m,Stuart.jpg,pieFS2.bmp,Stuart declared bankruptcy after he was laid off.,2,na,719101,720201,1100,z,1
220566,39,5,2,18,20,m,Paul.jpg,pieFS5.bmp,Paul is saving for his son's operation,2,na,732294,733370,1076,z,1
220566,40,3,4,9,13,m,Alan.jpg,pieFS3.bmp,Alan bullies his employees to put in extra hours at work.,1,reputation,745470,748081,2611,z,1
220566,41,4,3,12,15,f,Kelly.jpg,pieFS4.bmp,Kelly was a victim of identity theft and is now thousands of dollars in debt.,2,na,760168,761543,1375,z,1
220566,42,5,1,9,10,f,Mary.jpg,pieFS5.bmp,Mary claims false expenses for her reportable work travel.,1,reputation,773628,777723,4095,z,1
220566,43,4,1,4,5,f,Jean.jpg,pieFS4.bmp,Jean works two waitressing jobs to pay her bills.,2,na,789814,790491,677,z,1
220566,44,4,1,4,5,m,Darnell.jpg,pieFS4.bmp,Darnell takes valuables from his friends' homes when asked to house-sit.,1,reputation,802589,803574,985,z,1
220566,45,1,5,5,10,f,Maria.jpg,pieFS1.bmp,Maria just received a huge cash settlement,1,resources,815665,817640,1975,z,1
220566,46,3,6,14,20,m,Sam.jpg,pieFS3.bmp,Sam was injured in a hit-and-run accident and cannot afford his medical bills.,2,na,829727,831365,1638,z,1
220566,47,1,10,10,20,f,Fay.jpg,pieFS1.bmp,Fay works as a cleaner in a hotel,2,na,843455,845183,1728,z,1
220566,48,5,1,9,10,f,Louise.jpg,pieFS5.bmp,Louise's husband is a wealthy investment banker,1,resources,857283,859560,2277,z,1
220566,49,5,1,9,10,f,Kay.jpg,pieFS5.bmp,Kay can't afford to pay her medical bills,2,na,871646,873758,2112,z,1
220566,50,5,1,9,10,m,Ian.jpg,pieFS5.bmp,Ian was mugged and had his wallet stolen.,2,na,885842,887201,1359,z,1
220566,51,3,2,4,6,f,Monica.jpg,pieFS3.bmp,Monica takes discarded food from grocery stores to feed her children.,2,na,899286,900757,1471,z,1
220566,52,2,6,9,15,m,Tony.jpg,pieFS2.bmp,Tony often goes through and steals the neighbors' mail.,1,reputation,912847,917439,4592,z,1
220597,1,4,2,8,10,m,Ricky.jpg,pieFS4.bmp,Ricky employs illegal immigrants and pays them less than minimum wage.,1,reputation,78247,83731,5484,q,1
220597,2,2,3,4,7,f,Maria.jpg,pieFS2.bmp,Maria got a large cash bonus from her boss,1,resources,96027,105091,9064,q,1
220597,3,5,1,9,10,f,Miriam.jpg,pieFS5.bmp,Miriam owns an international company,1,resources,117353,119451,2098,q,1
220597,4,5,1,9,10,m,Mark.jpg,pieFS5.bmp,Mark lives in a luxury penthouse apartment,1,resources,131704,132552,848,q,1
220597,5,2,6,9,15,m,Darnell.jpg,pieFS2.bmp,Darnell stole money from his mother's wallet.,1,reputation,144823,164653,19830,q,1
220597,6,3,2,4,6,f,Trish.jpg,pieFS3.bmp,Trish received a large inheritance from a distant relative,1,resources,176938,179573,2635,q,1
220597,7,3,6,14,20,m,Matt.jpg,pieFS3.bmp,Matt lost his life savings when his small business failed,2,na,191838,192933,1095,q,1
220597,8,5,1,9,10,f,Kelly.jpg,pieFS5.bmp,Kelly was a victim of identity theft and is now thousands of dollars in debt.,2,na,205207,208714,3507,q,1
220597,9,1,9,9,18,m,Don.jpg,pieFS1.bmp,Don cheated on his taxes and is now under investigation for tax fraud.,1,reputation,220989,229494,8505,q,1
220597,10,2,7,10,17,f,Arianna.jpg,pieFS2.bmp,Arianna is a single mother,2,na,241750,247055,5305,q,1
220597,11,1,8,8,16,m,George.jpg,pieFS1.bmp,George could not afford his mortgage and his home was foreclosed.,2,na,259330,262015,2685,q,1
220597,12,4,2,8,10,f,Lauren.jpg,pieFS4.bmp,Lauren works two waitressing jobs to pay her bills.,2,na,274281,276276,1995,q,1
220597,13,5,2,18,20,m,Nick.jpg,pieFS5.bmp,Nick is a veteran having trouble finding employment.,2,na,288532,290816,2284,q,1
220597,14,3,5,11,16,f,Cindy.jpg,pieFS3.bmp,Cindy just received a huge cash settlement,1,resources,303049,310257,7208,q,1
220597,15,4,4,16,20,f,Janet.jpg,pieFS4.bmp,Janet just won the lottery,1,resources,322511,323397,886,q,1
220597,16,3,4,9,13,m,Jack.jpg,pieFS3.bmp,Jack stole his elderly father's prescription medications.,1,reputation,335613,340398,4785,q,1
220597,17,4,3,12,15,m,Daniel.jpg,pieFS4.bmp,Daniel is hiding his taxable income in Switzerland.,1,reputation,352611,354218,1607,q,1
220597,18,5,1,9,10,f,Beth.jpg,pieFS5.bmp,Beth cannot afford to send her son to college.,2,na,366446,396219,29773,q,1
220597,19,1,10,10,20,f,Emily.jpg,pieFS1.bmp,Emily takes discarded food from grocery stores to feed her children.,2,na,408433,417599,9166,q,1
220597,20,3,4,9,13,m,Justin.jpg,pieFS3.bmp,Justin underreports his company's earnings and pockets the profits.,1,reputation,429826,442460,12634,p,0
220597,21,5,1,9,10,f,Fay.jpg,pieFS5.bmp,Fay regularly fires employees to avoid promoting them.,1,reputation,454682,469001,14319,p,0
220597,22,4,1,4,5,m,Joe.jpg,pieFS4.bmp,Joe is a well paid lawyer,1,resources,481219,483141,1922,q,1
220597,23,4,1,4,5,m,Ben.jpg,pieFS4.bmp,Ben declared bankruptcy after he was laid off.,2,na,495354,507722,12368,q,1
220597,24,3,3,7,10,m,Michael.jpg,pieFS3.bmp,Michael takes valuables from his friends' homes when asked to house-sit.,1,reputation,519926,526002,6076,q,1
220597,25,3,3,7,10,f,Joanna.jpg,pieFS3.bmp,Joanna steals her coworkers' tips to buy alcohol.,1,reputation,538240,543343,5103,p,0
220597,26,4,4,16,20,m,Saul.jpg,pieFS4.bmp,Saul was injured in a hit-and-run accident and cannot afford his medical bills.,2,na,555571,556903,1332,q,1
220597,27,2,6,9,15,m,Brad.jpg,pieFS2.bmp,Brad was mugged and had his wallet stolen.,2,na,569122,570783,1661,q,1
220597,28,5,2,18,20,m,Ian.jpg,pieFS5.bmp,Ian often goes through and steals the neighbors' mail.,1,reputation,583007,585404,2397,q,1
220597,29,3,6,14,20,m,Jared.jpg,pieFS3.bmp,Jared is a retiree,2,na,597624,599564,1940,q,1
220597,30,3,2,4,6,f,Jean.jpg,pieFS3.bmp,Jean just lost her small business after a franchise moved in next door.,2,na,611775,613604,1829,q,1
220597,31,4,3,12,15,f,Jenny.jpg,pieFS4.bmp,Jenny used her mother's social security number to open a credit card account.,1,reputation,625826,651614,25788,p,0
220597,32,5,1,9,10,f,Monica.jpg,pieFS5.bmp,Monica is raising money to buy gifts for children in need.,2,na,663851,665646,1795,q,1
220597,33,3,4,9,13,m,Edward.jpg,pieFS3.bmp,Edward just bought an expensive sports car,1,resources,677869,683187,5318,q,1
220597,34,5,1,9,10,f,Mary.jpg,pieFS5.bmp,Mary secretly gambles with her husband's savings.,1,reputation,695416,695987,571,q,1
220597,35,4,3,12,15,m,Peter.jpg,pieFS4.bmp,Peter has been unable to find a job for over a year.,2,na,708219,744666,36447,q,1
220597,36,3,5,11,16,m,Sam.jpg,pieFS3.bmp,Sam lost his house in a fire,2,na,756899,757448,549,q,1
220597,37,5,2,18,20,m,Alan.jpg,pieFS5.bmp,Alan is saving for his son's operation,2,na,769651,770129,478,q,1
220597,38,5,2,18,20,m,Kevin.jpg,pieFS5.bmp,Kevin just found $50 on the street,1,resources,782354,783109,755,q,1
220597,39,2,8,12,20,f,Fiona.jpg,pieFS2.bmp,Fiona claims false expenses for her reportable work travel.,1,reputation,795340,800349,5009,q,1
220597,40,4,2,8,10,m,Paul.jpg,pieFS4.bmp,Paul bullies his employees to put in extra hours at work.,1,reputation,812571,818410,5839,q,1
220597,41,3,2,4,6,f,Kay.jpg,pieFS3.bmp,Kay works as a cleaner in a hotel,2,na,830617,840251,9634,q,1
220597,42,5,1,9,10,m,Stuart.jpg,pieFS5.bmp,Stuart is homeless,2,na,852460,876271,23811,q,1
220597,43,5,2,18,20,f,Marny.jpg,pieFS5.bmp,Marny illegally parks in the disabled parking spots when she can.,1,reputation,888520,890392,1872,p,0
220597,44,4,1,4,5,f,Jackie.jpg,pieFS4.bmp,Jackie's car with her bag and credit cards was recently stolen.,2,na,902621,903032,411,q,1
220597,45,5,1,9,10,m,Tony.jpg,pieFS5.bmp,Tony is saving to pay his university fees,2,na,915241,923853,8612,q,1
220597,46,4,4,16,20,f,Emma.jpg,pieFS4.bmp,Emma's husband is a wealthy investment banker,1,resources,936085,957634,21549,q,1
220597,47,4,3,12,15,f,Sharon.jpg,pieFS4.bmp,Sharon can't afford to pay her medical bills,2,na,969864,972314,2450,q,1
220597,48,4,2,8,10,f,Eileen.jpg,pieFS4.bmp,Eileen just found out that her husband has incurred a large credit card debt.,2,na,984531,985934,1403,q,1
220597,49,1,5,5,10,f,Deborah.jpg,pieFS1.bmp,Deborah is a highly paid actress,1,resources,998166,999975,1809,q,1
220597,50,2,3,4,7,m,Taymar.jpg,pieFS2.bmp,Taymar just lost his job,2,na,1012184,1013615,1431,q,1
220597,51,3,3,7,10,f,Louise.jpg,pieFS3.bmp,Louise is going to be evicted because she is behind on her rent,2,na,1025819,1026156,337,q,1
220597,52,3,2,4,6,f,Sammy.jpg,pieFS3.bmp,Sammy has to take an unpaid leave of absence because her mother broke her hip.,2,na,1038355,1040256,1901,q,1
220649,1,4,3,12,15,m,Peter.jpg,pieFS4.bmp,Peter is a veteran having trouble finding employment.,2,na,59269,61895,2626,q,1
220649,2,3,2,4,6,f,Sammy.jpg,pieFS3.bmp,Sammy's car with her bag and credit cards was recently stolen.,2,na,74086,76316,2230,q,1
220649,3,3,3,7,10,m,Michael.jpg,pieFS3.bmp,Michael stole his elderly father's prescription medications.,1,reputation,88486,90756,2270,p,0
220649,4,5,1,9,10,m,Brad.jpg,pieFS5.bmp,Brad declared bankruptcy after he was laid off.,2,na,102954,105496,2542,q,1
220649,5,5,2,18,20,m,Paul.jpg,pieFS5.bmp,Paul is hiding his taxable income in Switzerland.,1,reputation,117688,120557,2869,p,0
220649,6,4,2,8,10,m,Stuart.jpg,pieFS4.bmp,Stuart takes valuables from his friends' homes when asked to house-sit.,1,reputation,132754,134597,1843,p,0
220649,7,5,1,9,10,f,Beth.jpg,pieFS5.bmp,Beth cannot afford to send her son to college.,2,na,146789,152098,5309,p,0
220649,8,5,1,9,10,f,Maria.jpg,pieFS5.bmp,Maria just found out that her husband has incurred a large credit card debt.,2,na,164303,170318,6015,p,0
220649,9,2,3,4,7,f,Louise.jpg,pieFS2.bmp,Louise regularly fires employees to avoid promoting them.,1,reputation,182516,193179,10663,q,1
220649,10,5,2,18,20,f,Mary.jpg,pieFS5.bmp,Mary secretly gambles with her husband's savings.,1,reputation,205374,209819,4445,p,0
220649,11,4,4,16,20,f,Jackie.jpg,pieFS4.bmp,Jackie is a highly paid actress,1,resources,221989,229300,7311,q,1
220649,12,3,4,9,13,m,Alan.jpg,pieFS3.bmp,Alan underreports his company's earnings and pockets the profits.,1,reputation,241468,255080,13612,p,0
220649,13,2,7,10,17,f,Jenny.jpg,pieFS2.bmp,Jenny has to take an unpaid leave of absence because her mother broke her hip.,2,na,267256,269341,2085,q,1
220649,14,3,6,14,20,m,Nick.jpg,pieFS3.bmp,Nick was injured in a hit-and-run accident and cannot afford his medical bills.,2,na,281507,283521,2014,q,1
220649,15,5,1,9,10,f,Emma.jpg,pieFS5.bmp,Emma claims false expenses for her reportable work travel.,1,reputation,295708,298201,2493,p,0
220649,16,5,1,9,10,f,Kelly.jpg,pieFS5.bmp,Kelly got a large cash bonus from her boss,1,resources,310392,312802,2410,p,0
220649,17,4,1,4,5,m,Edward.jpg,pieFS4.bmp,Edward is a well paid lawyer,1,resources,324992,327182,2190,p,0
220649,18,3,5,11,16,m,Taymar.jpg,pieFS3.bmp,Taymar is a retiree,2,na,339343,341702,2359,q,1
220649,19,5,2,18,20,m,Mark.jpg,pieFS5.bmp,Mark was mugged and had his wallet stolen.,2,na,353861,358503,4642,q,1
220649,20,4,3,12,15,f,Fay.jpg,pieFS4.bmp,Fay works as a cleaner in a hotel,2,na,370659,374843,4184,q,1
220649,21,3,5,11,16,f,Janet.jpg,pieFS3.bmp,Janet's husband is a wealthy investment banker,1,resources,387007,390164,3157,q,1
220649,22,3,3,7,10,f,Joanna.jpg,pieFS3.bmp,Joanna was a victim of identity theft and is now thousands of dollars in debt.,2,na,402340,404484,2144,q,1
220649,23,3,2,4,6,f,Kay.jpg,pieFS3.bmp,Kay can't afford to pay her medical bills,2,na,416641,418564,1923,q,1
220649,24,1,10,10,20,f,Sharon.jpg,pieFS1.bmp,Sharon is going to be evicted because she is behind on her rent,2,na,430743,433985,3242,q,1
220649,25,5,2,18,20,m,Saul.jpg,pieFS5.bmp,Saul often goes through and steals the neighbors' mail.,1,reputation,446142,448245,2103,p,0
220649,26,5,1,9,10,m,Joe.jpg,pieFS5.bmp,Joe just bought an expensive sports car,1,resources,460410,463966,3556,p,0
220649,27,4,1,4,5,f,Emily.jpg,pieFS4.bmp,Emily works two waitressing jobs to pay her bills.,2,na,476159,479006,2847,q,1
220649,28,2,6,9,15,m,Don.jpg,pieFS2.bmp,Don has been unable to find a job for over a year.,2,na,491193,493326,2133,q,1
220649,29,4,3,12,15,f,Trish.jpg,pieFS4.bmp,Trish owns an international company,1,resources,505527,508847,3320,p,0
220649,30,5,1,9,10,f,Deborah.jpg,pieFS5.bmp,Deborah just received a huge cash settlement,1,resources,521043,523067,2024,p,0
220649,31,4,1,4,5,m,Ricky.jpg,pieFS4.bmp,Ricky is saving for his son's operation,2,na,535227,537087,1860,q,1
220649,32,5,2,18,20,m,Matt.jpg,pieFS5.bmp,Matt lost his house in a fire,2,na,549262,551168,1906,q,1
220649,33,3,4,9,13,m,George.jpg,pieFS3.bmp,George bullies his employees to put in extra hours at work.,1,reputation,563346,568528,5182,p,0
220649,34,2,8,12,20,f,Fiona.jpg,pieFS2.bmp,Fiona received a large inheritance from a distant relative,1,resources,580694,582869,2175,q,1
220649,35,5,1,9,10,f,Lauren.jpg,pieFS5.bmp,Lauren takes discarded food from grocery stores to feed her children.,2,na,595045,596929,1884,q,1
220649,36,1,9,9,18,m,Tony.jpg,pieFS1.bmp,Tony just found $50 on the street,1,resources,609079,611169,2090,q,1
220649,37,3,6,14,20,m,Darnell.jpg,pieFS3.bmp,Darnell is homeless,2,na,623330,625530,2200,q,1
220649,38,4,4,16,20,m,Ian.jpg,pieFS4.bmp,Ian is saving to pay his university fees,2,na,637698,639630,1932,q,1
220649,39,4,2,8,10,m,Ben.jpg,pieFS4.bmp,Ben lives in a luxury penthouse apartment,1,resources,651799,653830,2031,p,0
220649,40,3,4,9,13,m,Jack.jpg,pieFS3.bmp,Jack stole money from his mother's wallet.,1,reputation,665983,668711,2728,p,0
220649,41,4,4,16,20,f,Monica.jpg,pieFS4.bmp,Monica steals her coworkers' tips to buy alcohol.,1,reputation,680884,684271,3387,p,0
220649,42,4,2,8,10,f,Jean.jpg,pieFS4.bmp,Jean just lost her small business after a franchise moved in next door.,2,na,696450,704452,8002,q,1
220649,43,3,2,4,6,f,Arianna.jpg,pieFS3.bmp,Arianna is a single mother,2,na,716627,718752,2125,q,1
220649,44,3,2,4,6,f,Eileen.jpg,pieFS3.bmp,Eileen used her mother's social security number to open a credit card account.,1,reputation,730928,741073,10145,q,1
220649,45,5,1,9,10,m,Kevin.jpg,pieFS5.bmp,Kevin lost his life savings when his small business failed,2,na,753237,769233,15996,q,1
220649,46,3,3,7,10,f,Miriam.jpg,pieFS3.bmp,Miriam just won the lottery,1,resources,781406,783654,2248,q,1
220649,47,2,3,4,7,m,Daniel.jpg,pieFS2.bmp,Daniel just lost his job,2,na,795824,797854,2030,q,1
220649,48,4,2,8,10,f,Cindy.jpg,pieFS4.bmp,Cindy is raising money to buy gifts for children in need.,2,na,810025,812095,2070,q,1
220649,49,4,3,12,15,m,Justin.jpg,pieFS4.bmp,Justin employs illegal immigrants and pays them less than minimum wage.,1,reputation,824259,826595,2336,p,0
220649,50,2,6,9,15,m,Sam.jpg,pieFS2.bmp,Sam cheated on his taxes and is now under investigation for tax fraud.,1,reputation,838776,841395,2619,q,1
220649,51,1,8,8,16,m,Jared.jpg,pieFS1.bmp,Jared could not afford his mortgage and his home was foreclosed.,2,na,853560,856536,2976,q,1
220649,52,1,5,5,10,f,Marny.jpg,pieFS1.bmp,Marny illegally parks in the disabled parking spots when she can.,1,reputation,868710,876016,7306,q,1
220678,1,1,5,5,10,f,Beth.jpg,pieFS1.bmp,Beth just won the lottery,1,resources,23796,27336,3540,z,1
220678,2,3,3,7,10,f,Sharon.jpg,pieFS3.bmp,Sharon cannot afford to send her son to college.,2,na,39447,91214,51767,z,1
220678,3,4,1,4,5,m,Joe.jpg,pieFS4.bmp,Joe could not afford his mortgage and his home was foreclosed.,2,na,103321,104230,909,z,1
220678,4,3,4,9,13,m,Ricky.jpg,pieFS3.bmp,Ricky is hiding his taxable income in Switzerland.,1,reputation,116330,119075,2745,z,1
220678,5,3,6,14,20,m,Ian.jpg,pieFS3.bmp,Ian is saving to pay his university fees,2,na,131144,132247,1103,z,1
220678,6,1,9,9,18,m,George.jpg,pieFS1.bmp,George underreports his company's earnings and pockets the profits.,1,reputation,144320,144936,616,z,1
220678,7,2,3,4,7,f,Emily.jpg,pieFS2.bmp,Emily just received a huge cash settlement,1,resources,157045,158827,1782,z,1
220678,8,4,1,4,5,m,Paul.jpg,pieFS4.bmp,Paul is a well paid lawyer,1,resources,170923,171808,885,z,1
220678,9,4,2,8,10,f,Deborah.jpg,pieFS4.bmp,Deborah takes discarded food from grocery stores to feed her children.,2,na,183899,185094,1195,z,1
220678,10,5,2,18,20,m,Peter.jpg,pieFS5.bmp,Peter lives in a luxury penthouse apartment,1,resources,197209,198438,1229,z,1
220678,11,4,3,12,15,f,Monica.jpg,pieFS4.bmp,Monica steals her coworkers' tips to buy alcohol.,1,reputation,210518,211705,1187,z,1
220678,12,5,1,9,10,f,Joanna.jpg,pieFS5.bmp,Joanna just lost her small business after a franchise moved in next door.,2,na,223795,224815,1020,z,1
220678,13,5,1,9,10,f,Trish.jpg,pieFS5.bmp,Trish regularly fires employees to avoid promoting them.,1,reputation,236887,247003,10116,z,1
220678,14,5,2,18,20,m,Darnell.jpg,pieFS5.bmp,Darnell stole money from his mother's wallet.,1,reputation,259093,260582,1489,z,1
220678,15,3,5,11,16,m,Michael.jpg,pieFS3.bmp,Michael lost his life savings when his small business failed,2,na,272653,273614,961,z,1
220678,16,3,5,11,16,f,Janet.jpg,pieFS3.bmp,Janet secretly gambles with her husband's savings.,1,reputation,285712,286693,981,z,1
220678,17,2,6,9,15,m,Justin.jpg,pieFS2.bmp,Justin is a retiree,2,na,298771,300334,1563,z,1
220678,18,3,3,7,10,m,Matt.jpg,pieFS3.bmp,Matt cheated on his taxes and is now under investigation for tax fraud.,1,reputation,312432,314788,2356,z,1
220678,19,5,1,9,10,m,Saul.jpg,pieFS5.bmp,Saul is a veteran having trouble finding employment.,2,na,326863,329117,2254,z,1
220678,20,5,1,9,10,f,Louise.jpg,pieFS5.bmp,Louise claims false expenses for her reportable work travel.,1,reputation,341192,342727,1535,z,1
220678,21,2,6,9,15,m,Jared.jpg,pieFS2.bmp,Jared just bought an expensive sports car,1,resources,354803,355664,861,z,1
220678,22,5,1,9,10,m,Alan.jpg,pieFS5.bmp,Alan is saving for his son's operation,2,na,367745,368541,796,z,1
220678,23,4,2,8,10,m,Brad.jpg,pieFS4.bmp,Brad stole his elderly father's prescription medications.,1,reputation,380620,381256,636,z,1
220678,24,4,2,8,10,m,Edward.jpg,pieFS4.bmp,Edward bullies his employees to put in extra hours at work.,1,reputation,393345,395527,2182,z,1
220678,25,4,3,12,15,f,Fay.jpg,pieFS4.bmp,Fay works as a cleaner in a hotel,2,na,407624,408311,687,z,1
220678,26,3,2,4,6,f,Lauren.jpg,pieFS3.bmp,Lauren used her mother's social security number to open a credit card account.,1,reputation,420399,421419,1020,z,1
220678,27,5,1,9,10,f,Jenny.jpg,pieFS5.bmp,Jenny is raising money to buy gifts for children in need.,2,na,433508,434354,846,z,1
220678,28,3,6,14,20,m,Jack.jpg,pieFS3.bmp,Jack declared bankruptcy after he was laid off.,2,na,446450,448170,1720,z,1
220678,29,2,8,12,20,f,Kelly.jpg,pieFS2.bmp,Kelly illegally parks in the disabled parking spots when she can.,1,reputation,460262,460697,435,z,1
220678,30,3,3,7,10,f,Miriam.jpg,pieFS3.bmp,Miriam's husband is a wealthy investment banker,1,resources,472786,473822,1036,z,1
220678,31,4,3,12,15,m,Tony.jpg,pieFS4.bmp,Tony takes valuables from his friends' homes when asked to house-sit.,1,reputation,485912,488313,2401,z,1
220678,32,4,1,4,5,f,Jackie.jpg,pieFS4.bmp,Jackie's car with her bag and credit cards was recently stolen.,2,na,500409,501548,1139,z,1
220678,33,4,2,8,10,f,Marny.jpg,pieFS4.bmp,Marny just found out that her husband has incurred a large credit card debt.,2,na,513635,521549,7914,z,1
220678,34,4,4,16,20,m,Sam.jpg,pieFS4.bmp,Sam was injured in a hit-and-run accident and cannot afford his medical bills.,2,na,533650,534326,676,z,1
220678,35,2,3,4,7,m,Stuart.jpg,pieFS2.bmp,Stuart was mugged and had his wallet stolen.,2,na,546425,547582,1157,z,1
220678,36,5,2,18,20,f,Maria.jpg,pieFS5.bmp,Maria is a highly paid actress,1,resources,559668,561333,1665,z,1
220678,37,3,4,9,13,m,Don.jpg,pieFS3.bmp,Don often goes through and steals the neighbors' mail.,1,reputation,573429,574271,842,z,1
220678,38,3,2,4,6,f,Fiona.jpg,pieFS3.bmp,Fiona can't afford to pay her medical bills,2,na,586354,587131,777,z,1
220678,39,4,3,12,15,m,Ben.jpg,pieFS4.bmp,Ben has been unable to find a job for over a year.,2,na,599213,600303,1090,z,1
220678,40,5,1,9,10,f,Mary.jpg,pieFS5.bmp,Mary is going to be evicted because she is behind on her rent,2,na,612389,613335,946,z,1
220678,41,5,1,9,10,f,Kay.jpg,pieFS5.bmp,Kay owns an international company,1,resources,625414,626273,859,z,1
220678,42,2,7,10,17,f,Eileen.jpg,pieFS2.bmp,Eileen has to take an unpaid leave of absence because her mother broke her hip.,2,na,638373,639180,807,z,1
220678,43,5,2,18,20,m,Mark.jpg,pieFS5.bmp,Mark lost his house in a fire,2,na,651265,651940,675,z,1
220678,44,3,4,9,13,m,Nick.jpg,pieFS3.bmp,Nick just found $50 on the street,1,resources,664039,664743,704,z,1
220678,45,4,4,16,20,f,Jean.jpg,pieFS4.bmp,Jean got a large cash bonus from her boss,1,resources,676814,677666,852,z,1
220678,46,5,2,18,20,m,Daniel.jpg,pieFS5.bmp,Daniel just lost his job,2,na,689739,691276,1537,z,1
220678,47,1,10,10,20,f,Cindy.jpg,pieFS1.bmp,Cindy was a victim of identity theft and is now thousands of dollars in debt.,2,na,703367,703876,509,z,1
220678,48,4,4,16,20,f,Arianna.jpg,pieFS4.bmp,Arianna received a large inheritance from a distant relative,1,resources,715975,716551,576,z,1
220678,49,3,2,4,6,f,Sammy.jpg,pieFS3.bmp,Sammy works two waitressing jobs to pay her bills.,2,na,728632,729856,1224,z,1
220678,50,3,2,4,6,f,Emma.jpg,pieFS3.bmp,Emma is a single mother,2,na,741925,742443,518,z,1
220678,51,1,8,8,16,m,Kevin.jpg,pieFS1.bmp,Kevin is homeless,2,na,754516,755248,732,z,1
220678,52,5,1,9,10,m,Taymar.jpg,pieFS5.bmp,Taymar employs illegal immigrants and pays them less than minimum wage.,1,reputation,767341,768130,789,z,1
220684,1,3,3,7,10,m,Ian.jpg,pieFS3.bmp,Ian takes valuables from his friends' homes when asked to house-sit.,1,reputation,25820,27566,1746,m,0
220684,2,2,3,4,7,m,Don.jpg,pieFS2.bmp,Don was injured in a hit-and-run accident and cannot afford his medical bills.,2,na,39682,41974,2292,m,0
220684,3,3,3,7,10,f,Fiona.jpg,pieFS3.bmp,Fiona just won the lottery,1,resources,54045,56599,2554,z,1
220684,4,3,6,14,20,m,Tony.jpg,pieFS3.bmp,Tony was mugged and had his wallet stolen.,2,na,68676,71444,2768,z,1
220684,5,3,2,4,6,f,Joanna.jpg,pieFS3.bmp,Joanna just received a huge cash settlement,1,resources,83524,86210,2686,z,1
220684,6,1,9,9,18,m,Darnell.jpg,pieFS1.bmp,Darnell often goes through and steals the neighbors' mail.,1,reputation,98322,100820,2498,m,0
220684,7,2,7,10,17,f,Janet.jpg,pieFS2.bmp,Janet cannot afford to send her son to college.,2,na,112920,124165,11245,z,1
220684,8,5,1,9,10,m,Kevin.jpg,pieFS5.bmp,Kevin has been unable to find a job for over a year.,2,na,136279,138103,1824,z,1
220684,9,4,3,12,15,m,Nick.jpg,pieFS4.bmp,Nick lost his house in a fire,2,na,150207,152479,2272,z,1
220684,10,5,1,9,10,f,Jenny.jpg,pieFS5.bmp,Jenny takes discarded food from grocery stores to feed her children.,2,na,164570,166469,1899,z,1
220684,11,4,4,16,20,m,Taymar.jpg,pieFS4.bmp,Taymar is saving for his son's operation,2,na,178549,181090,2541,z,1
220684,12,5,2,18,20,m,Saul.jpg,pieFS5.bmp,Saul just found $50 on the street,1,resources,193163,194997,1834,z,1
220684,13,4,4,16,20,f,Miriam.jpg,pieFS4.bmp,Miriam regularly fires employees to avoid promoting them.,1,reputation,207092,208685,1593,m,0
220684,14,4,3,12,15,m,Justin.jpg,pieFS4.bmp,Justin bullies his employees to put in extra hours at work.,1,reputation,220769,222229,1460,m,0
220684,15,2,6,9,15,m,Joe.jpg,pieFS2.bmp,Joe just lost his job,2,na,234313,235468,1155,z,1
220684,16,4,1,4,5,m,Matt.jpg,pieFS4.bmp,Matt is homeless,2,na,247539,249250,1711,z,1
220684,17,2,3,4,7,f,Deborah.jpg,pieFS2.bmp,Deborah steals her coworkers' tips to buy alcohol.,1,reputation,261317,262407,1090,m,0
220684,18,3,5,11,16,m,Michael.jpg,pieFS3.bmp,Michael is saving to pay his university fees,2,na,274494,276611,2117,z,1
220684,19,4,1,4,5,m,Mark.jpg,pieFS4.bmp,Mark lives in a luxury penthouse apartment,1,resources,288706,290308,1602,z,1
220684,20,3,2,4,6,f,Sammy.jpg,pieFS3.bmp,Sammy just lost her small business after a franchise moved in next door.,2,na,302401,304315,1914,z,1
220684,21,5,1,9,10,m,Edward.jpg,pieFS5.bmp,Edward employs illegal immigrants and pays them less than minimum wage.,1,reputation,316413,318003,1590,m,0
220684,22,5,2,18,20,m,George.jpg,pieFS5.bmp,George could not afford his mortgage and his home was foreclosed.,2,na,330090,331801,1711,z,1
220684,23,5,1,9,10,f,Louise.jpg,pieFS5.bmp,Louise secretly gambles with her husband's savings.,1,reputation,343869,345693,1824,m,0
220684,24,5,2,18,20,m,Ricky.jpg,pieFS5.bmp,Ricky is hiding his taxable income in Switzerland.,1,reputation,357780,358568,788,m,0
220684,25,5,1,9,10,f,Marny.jpg,pieFS5.bmp,Marny used her mother's social security number to open a credit card account.,1,reputation,370655,371694,1039,m,0
220684,26,4,1,4,5,f,Eileen.jpg,pieFS4.bmp,Eileen is raising money to buy gifts for children in need.,2,na,383781,385007,1226,z,1
220684,27,4,2,8,10,m,Ben.jpg,pieFS4.bmp,Ben stole money from his mother's wallet.,1,reputation,397074,398086,1012,m,0
220684,28,2,8,12,20,f,Arianna.jpg,pieFS2.bmp,Arianna claims false expenses for her reportable work travel.,1,reputation,410184,411485,1301,m,0
220684,29,5,1,9,10,f,Maria.jpg,pieFS5.bmp,Maria illegally parks in the disabled parking spots when she can.,1,reputation,423577,425275,1698,m,0
220684,30,3,2,4,6,f,Jackie.jpg,pieFS3.bmp,Jackie's car with her bag and credit cards was recently stolen.,2,na,437372,437994,622,z,1
220684,31,3,4,9,13,m,Alan.jpg,pieFS3.bmp,Alan underreports his company's earnings and pockets the profits.,1,reputation,450080,452167,2087,m,0
220684,32,1,10,10,20,f,Kay.jpg,pieFS1.bmp,Kay works as a cleaner in a hotel,2,na,464242,465351,1109,z,1
220684,33,5,1,9,10,f,Emily.jpg,pieFS5.bmp,Emily just found out that her husband has incurred a large credit card debt.,2,na,477452,479997,2545,z,1
220684,34,1,5,5,10,f,Lauren.jpg,pieFS1.bmp,Lauren is a highly paid actress,1,resources,492082,493357,1275,z,1
220684,35,3,5,11,16,f,Trish.jpg,pieFS3.bmp,Trish's husband is a wealthy investment banker,1,resources,505442,506670,1228,z,1
220684,36,3,3,7,10,f,Sharon.jpg,pieFS3.bmp,Sharon can't afford to pay her medical bills,2,na,518752,519968,1216,z,1
220684,37,5,1,9,10,m,Sam.jpg,pieFS5.bmp,Sam lost his life savings when his small business failed,2,na,532045,533703,1658,z,1
220684,38,5,1,9,10,f,Monica.jpg,pieFS5.bmp,Monica has to take an unpaid leave of absence because her mother broke her hip.,2,na,545790,547125,1335,z,1
220684,39,3,4,9,13,m,Stuart.jpg,pieFS3.bmp,Stuart cheated on his taxes and is now under investigation for tax fraud.,1,reputation,559217,562626,3409,m,0
220684,40,3,6,14,20,m,Peter.jpg,pieFS3.bmp,Peter is a veteran having trouble finding employment.,2,na,574700,575721,1021,z,1
220684,41,4,3,12,15,f,Fay.jpg,pieFS4.bmp,Fay is going to be evicted because she is behind on her rent,2,na,587810,589397,1587,z,1
220684,42,4,4,16,20,f,Jean.jpg,pieFS4.bmp,Jean got a large cash bonus from her boss,1,resources,601471,602441,970,z,1
220684,43,2,6,9,15,m,Jack.jpg,pieFS2.bmp,Jack stole his elderly father's prescription medications.,1,reputation,614530,616598,2068,z,1
220684,44,4,2,8,10,f,Kelly.jpg,pieFS4.bmp,Kelly was a victim of identity theft and is now thousands of dollars in debt.,2,na,628692,629739,1047,z,1
220684,45,4,2,8,10,f,Cindy.jpg,pieFS4.bmp,Cindy works two waitressing jobs to pay her bills.,2,na,641835,642795,960,z,1
220684,46,5,2,18,20,m,Brad.jpg,pieFS5.bmp,Brad declared bankruptcy after he was laid off.,2,na,654894,656428,1534,z,1
220684,47,5,2,18,20,f,Emma.jpg,pieFS5.bmp,Emma owns an international company,1,resources,668521,669569,1048,z,1
220684,48,4,3,12,15,f,Mary.jpg,pieFS4.bmp,Mary received a large inheritance from a distant relative,1,resources,681664,682742,1078,z,1
220684,49,3,4,9,13,m,Paul.jpg,pieFS3.bmp,Paul is a well paid lawyer,1,resources,694823,696008,1185,z,1
220684,50,1,8,8,16,m,Jared.jpg,pieFS1.bmp,Jared is a retiree,2,na,708083,709880,1797,z,1
220684,51,3,2,4,6,f,Beth.jpg,pieFS3.bmp,Beth is a single mother,2,na,721961,723556,1595,z,1
220684,52,4,2,8,10,m,Daniel.jpg,pieFS4.bmp,Daniel just bought an expensive sports car,1,resources,735656,736807,1151,z,1
220740,1,3,4,9,13,m,Joe.jpg,pieFS3.bmp,Joe underreports his company's earnings and pockets the profits.,1,reputation,64975,72018,7043,q,1
220740,2,4,2,8,10,f,Fiona.jpg,pieFS4.bmp,Fiona is going to be evicted because she is behind on her rent,2,na,84237,91919,7682,q,1
220740,3,3,3,7,10,m,Paul.jpg,pieFS3.bmp,Paul is a well paid lawyer,1,resources,104132,106699,2567,q,1
220740,4,2,8,12,20,f,Jackie.jpg,pieFS2.bmp,Jackie just received a huge cash settlement,1,resources,118916,120320,1404,q,1
220740,5,3,6,14,20,m,Daniel.jpg,pieFS3.bmp,Daniel is a retiree,2,na,132534,133980,1446,q,1
220740,6,4,4,16,20,m,Don.jpg,pieFS4.bmp,Don is saving to pay his university fees,2,na,146185,147981,1796,q,1
220740,7,4,3,12,15,f,Trish.jpg,pieFS4.bmp,Trish owns an international company,1,resources,160187,162101,1914,q,1
220740,8,5,1,9,10,f,Monica.jpg,pieFS5.bmp,Monica takes discarded food from grocery stores to feed her children.,2,na,174354,177341,2987,p,0
220740,9,4,2,8,10,m,Peter.jpg,pieFS4.bmp,Peter lives in a luxury penthouse apartment,1,resources,189554,193562,4008,p,0
220740,10,4,4,16,20,f,Eileen.jpg,pieFS4.bmp,Eileen steals her coworkers' tips to buy alcohol.,1,reputation,205786,212982,7196,q,1
220740,11,2,7,10,17,f,Cindy.jpg,pieFS2.bmp,Cindy just lost her small business after a franchise moved in next door.,2,na,225198,226283,1085,q,1
220740,12,3,4,9,13,m,Edward.jpg,pieFS3.bmp,Edward just bought an expensive sports car,1,resources,238500,239903,1403,q,1
220740,13,5,1,9,10,f,Deborah.jpg,pieFS5.bmp,Deborah used her mother's social security number to open a credit card account.,1,reputation,252119,253863,1744,p,0
220740,14,4,1,4,5,m,Mark.jpg,pieFS4.bmp,Mark stole money from his mother's wallet.,1,reputation,266070,267384,1314,q,1
220740,15,5,2,18,20,f,Arianna.jpg,pieFS5.bmp,Arianna received a large inheritance from a distant relative,1,resources,279572,281464,1892,p,0
220740,16,3,2,4,6,f,Emma.jpg,pieFS3.bmp,Emma is a single mother,2,na,293673,294664,991,q,1
220740,17,2,3,4,7,f,Fay.jpg,pieFS2.bmp,Fay just won the lottery,1,resources,306875,307905,1030,q,1
220740,18,5,1,9,10,f,Marny.jpg,pieFS5.bmp,Marny is raising money to buy gifts for children in need.,2,na,320110,321805,1695,p,0
220740,19,3,5,11,16,m,Tony.jpg,pieFS3.bmp,Tony lost his life savings when his small business failed,2,na,334012,335126,1114,q,1
220740,20,5,2,18,20,m,Nick.jpg,pieFS5.bmp,Nick cheated on his taxes and is now under investigation for tax fraud.,1,reputation,347330,349106,1776,p,0
220740,21,2,6,9,15,m,Matt.jpg,pieFS2.bmp,Matt is a veteran having trouble finding employment.,2,na,361315,362226,911,q,1
220740,22,4,4,16,20,f,Kelly.jpg,pieFS4.bmp,Kelly illegally parks in the disabled parking spots when she can.,1,reputation,374434,376926,2492,q,1
220740,23,5,1,9,10,f,Janet.jpg,pieFS5.bmp,Janet cannot afford to send her son to college.,2,na,389151,390827,1676,p,0
220740,24,5,1,9,10,m,Ben.jpg,pieFS5.bmp,Ben stole his elderly father's prescription medications.,1,reputation,403036,404827,1791,p,0
220740,25,3,3,7,10,f,Lauren.jpg,pieFS3.bmp,Lauren's car with her bag and credit cards was recently stolen.,2,na,417037,418308,1271,q,1
220740,26,3,5,11,16,f,Sharon.jpg,pieFS3.bmp,Sharon regularly fires employees to avoid promoting them.,1,reputation,430522,431708,1186,q,1
220740,27,3,6,14,20,m,Ricky.jpg,pieFS3.bmp,Ricky is saving for his son's operation,2,na,443941,444948,1007,q,1
220740,28,4,1,4,5,m,Saul.jpg,pieFS4.bmp,Saul declared bankruptcy after he was laid off.,2,na,457159,458749,1590,q,1
220740,29,5,2,18,20,m,Jack.jpg,pieFS5.bmp,Jack takes valuables from his friends' homes when asked to house-sit.,1,reputation,470978,472869,1891,p,0
220740,30,4,2,8,10,m,Alan.jpg,pieFS4.bmp,Alan bullies his employees to put in extra hours at work.,1,reputation,485079,487950,2871,q,1
220740,31,5,1,9,10,m,Darnell.jpg,pieFS5.bmp,Darnell was injured in a hit-and-run accident and cannot afford his medical bills.,2,na,500162,502030,1868,p,0
220740,32,4,2,8,10,f,Jean.jpg,pieFS4.bmp,Jean just found out that her husband has incurred a large credit card debt.,2,na,514246,516070,1824,q,1
220740,33,1,5,5,10,f,Louise.jpg,pieFS1.bmp,Louise secretly gambles with her husband's savings.,1,reputation,528281,529731,1450,q,1
220740,34,5,1,9,10,f,Kay.jpg,pieFS5.bmp,Kay claims false expenses for her reportable work travel.,1,reputation,541933,543771,1838,p,0
220740,35,3,2,4,6,f,Jenny.jpg,pieFS3.bmp,Jenny is a highly paid actress,1,resources,555984,557171,1187,q,1
220740,36,2,3,4,7,m,Ian.jpg,pieFS2.bmp,Ian was mugged and had his wallet stolen.,2,na,569369,570391,1022,q,1
220740,37,3,2,4,6,f,Mary.jpg,pieFS3.bmp,Mary works as a cleaner in a hotel,2,na,582604,583952,1348,q,1
220740,38,2,6,9,15,m,Stuart.jpg,pieFS2.bmp,Stuart often goes through and steals the neighbors' mail.,1,reputation,596156,597313,1157,q,1
220740,39,1,8,8,16,m,George.jpg,pieFS1.bmp,George just lost his job,2,na,609525,610593,1068,q,1
220740,40,5,1,9,10,m,Kevin.jpg,pieFS5.bmp,Kevin has been unable to find a job for over a year.,2,na,622794,624913,2119,p,0
220740,41,3,4,9,13,m,Taymar.jpg,pieFS3.bmp,Taymar employs illegal immigrants and pays them less than minimum wage.,1,reputation,637128,638974,1846,q,1
220740,42,5,2,18,20,m,Michael.jpg,pieFS5.bmp,Michael lost his house in a fire,2,na,651179,654734,3555,p,0
220740,43,4,3,12,15,m,Sam.jpg,pieFS4.bmp,Sam just found $50 on the street,1,resources,666945,669114,2169,q,1
220740,44,5,2,18,20,m,Brad.jpg,pieFS5.bmp,Brad is homeless,2,na,681312,683275,1963,p,0
220740,45,4,3,12,15,f,Joanna.jpg,pieFS4.bmp,Joanna has to take an unpaid leave of absence because her mother broke her hip.,2,na,695480,697475,1995,q,1
220740,46,3,3,7,10,f,Emily.jpg,pieFS3.bmp,Emily got a large cash bonus from her boss,1,resources,709681,711016,1335,q,1
220740,47,4,3,12,15,m,Jared.jpg,pieFS4.bmp,Jared could not afford his mortgage and his home was foreclosed.,2,na,723216,724616,1400,q,1
220740,48,3,2,4,6,f,Maria.jpg,pieFS3.bmp,Maria was a victim of identity theft and is now thousands of dollars in debt.,2,na,736834,737936,1102,q,1
220740,49,1,9,9,18,m,Justin.jpg,pieFS1.bmp,Justin is hiding his taxable income in Switzerland.,1,reputation,750136,751416,1280,q,1
220740,50,4,1,4,5,f,Sammy.jpg,pieFS4.bmp,Sammy works two waitressing jobs to pay her bills.,2,na,763622,765397,1775,q,1
220740,51,5,1,9,10,f,Beth.jpg,pieFS5.bmp,Beth's husband is a wealthy investment banker,1,resources,777623,779917,2294,p,0
220740,52,1,10,10,20,f,Miriam.jpg,pieFS1.bmp,Miriam can't afford to pay her medical bills,2,na,792157,793898,1741,q,1
220758,1,4,3,12,15,m,Mark.jpg,pieFS4.bmp,Mark stole money from his mother's wallet.,1,reputation,39408,46046,6638,p,0
220758,2,5,1,9,10,f,Lauren.jpg,pieFS5.bmp,Lauren used her mother's social security number to open a credit card account.,1,reputation,58235,58548,313,p,0
220758,3,4,4,16,20,f,Louise.jpg,pieFS4.bmp,Louise regularly fires employees to avoid promoting them.,1,reputation,70742,77264,6522,q,1
220758,4,4,4,16,20,m,Tony.jpg,pieFS4.bmp,Tony lost his life savings when his small business failed,2,na,89453,93107,3654,q,1
220758,5,3,2,4,6,f,Fiona.jpg,pieFS3.bmp,Fiona secretly gambles with her husband's savings.,1,reputation,105321,119389,14068,q,1
220758,6,4,2,8,10,f,Joanna.jpg,pieFS4.bmp,Joanna is raising money to buy gifts for children in need.,2,na,131590,134994,3404,q,1
220758,7,3,4,9,13,m,Matt.jpg,pieFS3.bmp,Matt cheated on his taxes and is now under investigation for tax fraud.,1,reputation,147174,150387,3213,q,1
220758,8,2,3,4,7,f,Kelly.jpg,pieFS2.bmp,Kelly illegally parks in the disabled parking spots when she can.,1,reputation,162590,173706,11116,q,1
220758,9,4,1,4,5,m,Alan.jpg,pieFS4.bmp,Alan could not afford his mortgage and his home was foreclosed.,2,na,185899,194092,8193,q,1
220758,10,1,10,10,20,f,Jean.jpg,pieFS1.bmp,Jean's car with her bag and credit cards was recently stolen.,2,na,206315,214467,8152,p,0
220758,11,5,1,9,10,m,Kevin.jpg,pieFS5.bmp,Kevin is a veteran having trouble finding employment.,2,na,226648,231604,4956,q,1
220758,12,4,2,8,10,m,Brad.jpg,pieFS4.bmp,Brad stole his elderly father's prescription medications.,1,reputation,243787,245371,1584,q,1
220758,13,3,2,4,6,f,Maria.jpg,pieFS3.bmp,Maria just found out that her husband has incurred a large credit card debt.,2,na,257565,262507,4942,q,1
220758,14,4,3,12,15,f,Marny.jpg,pieFS4.bmp,Marny is a highly paid actress,1,resources,274704,276531,1827,q,1
220758,15,4,2,8,10,m,Jared.jpg,pieFS4.bmp,Jared is hiding his taxable income in Switzerland.,1,reputation,288699,290608,1909,q,1
220758,16,5,2,18,20,m,Jack.jpg,pieFS5.bmp,Jack declared bankruptcy after he was laid off.,2,na,302778,304956,2178,q,1
220758,17,3,5,11,16,f,Sharon.jpg,pieFS3.bmp,Sharon claims false expenses for her reportable work travel.,1,reputation,317158,330587,13429,p,0
220758,18,5,2,18,20,m,George.jpg,pieFS5.bmp,George underreports his company's earnings and pockets the profits.,1,reputation,342791,347573,4782,p,0
220758,19,4,2,8,10,f,Mary.jpg,pieFS4.bmp,Mary works as a cleaner in a hotel,2,na,359763,362723,2960,q,1
220758,20,4,1,4,5,m,Stuart.jpg,pieFS4.bmp,Stuart takes valuables from his friends' homes when asked to house-sit.,1,reputation,374912,377291,2379,p,0
220758,21,3,5,11,16,m,Don.jpg,pieFS3.bmp,Don was injured in a hit-and-run accident and cannot afford his medical bills.,2,na,389476,392534,3058,q,1
220758,22,3,3,7,10,f,Monica.jpg,pieFS3.bmp,Monica has to take an unpaid leave of absence because her mother broke her hip.,2,na,404726,408096,3370,q,1
220758,23,2,3,4,7,m,Sam.jpg,pieFS2.bmp,Sam was mugged and had his wallet stolen.,2,na,420293,425514,5221,q,1
220758,24,5,1,9,10,m,Joe.jpg,pieFS5.bmp,Joe is a well paid lawyer,1,resources,437716,442595,4879,q,1
220758,25,5,2,18,20,m,Nick.jpg,pieFS5.bmp,Nick often goes through and steals the neighbors' mail.,1,reputation,454788,456545,1757,p,0
220758,26,5,2,18,20,f,Janet.jpg,pieFS5.bmp,Janet's husband is a wealthy investment banker,1,resources,468733,476133,7400,q,1
220758,27,4,3,12,15,f,Arianna.jpg,pieFS4.bmp,Arianna can't afford to pay her medical bills,2,na,488313,490987,2674,q,1
220758,28,5,1,9,10,f,Beth.jpg,pieFS5.bmp,Beth is going to be evicted because she is behind on her rent,2,na,503161,504636,1475,q,1
220758,29,5,2,18,20,m,Peter.jpg,pieFS5.bmp,Peter has been unable to find a job for over a year.,2,na,516822,520649,3827,q,1
220758,30,4,3,12,15,m,Ben.jpg,pieFS4.bmp,Ben lost his house in a fire,2,na,532841,534143,1302,q,1
220758,31,1,8,8,16,m,Edward.jpg,pieFS1.bmp,Edward is a retiree,2,na,546335,549279,2944,q,1
220758,32,2,8,12,20,f,Trish.jpg,pieFS2.bmp,Trish owns an international company,1,resources,561484,563678,2194,q,1
220758,33,5,1,9,10,f,Emma.jpg,pieFS5.bmp,Emma received a large inheritance from a distant relative,1,resources,575864,578171,2307,q,1
220758,34,4,4,16,20,f,Sammy.jpg,pieFS4.bmp,Sammy got a large cash bonus from her boss,1,resources,590361,595247,4886,q,1
220758,35,1,9,9,18,m,Saul.jpg,pieFS1.bmp,Saul just found $50 on the street,1,resources,607466,614770,7304,q,1
220758,36,3,2,4,6,f,Jenny.jpg,pieFS3.bmp,Jenny was a victim of identity theft and is now thousands of dollars in debt.,2,na,626963,631194,4231,q,1
220758,37,2,7,10,17,f,Eileen.jpg,pieFS2.bmp,Eileen works two waitressing jobs to pay her bills.,2,na,643383,648125,4742,q,1
220758,38,3,3,7,10,m,Justin.jpg,pieFS3.bmp,Justin just bought an expensive sports car,1,resources,660321,662205,1884,q,1
220758,39,2,6,9,15,m,Michael.jpg,pieFS2.bmp,Michael is homeless,2,na,674400,677074,2674,q,1
220758,40,3,6,14,20,m,Paul.jpg,pieFS3.bmp,Paul is saving for his son's operation,2,na,689265,692467,3202,q,1
220758,41,5,1,9,10,f,Deborah.jpg,pieFS5.bmp,Deborah just received a huge cash settlement,1,resources,704665,708498,3833,q,1
220758,42,3,4,9,13,m,Ricky.jpg,pieFS3.bmp,Ricky bullies his employees to put in extra hours at work.,1,reputation,720683,737240,16557,q,1
220758,43,4,1,4,5,f,Emily.jpg,pieFS4.bmp,Emily takes discarded food from grocery stores to feed her children.,2,na,749393,751977,2584,q,1
220758,44,3,6,14,20,m,Taymar.jpg,pieFS3.bmp,Taymar just lost his job,2,na,764158,766152,1994,q,1
220758,45,3,2,4,6,f,Miriam.jpg,pieFS3.bmp,Miriam is a single mother,2,na,778337,781133,2796,q,1
220758,46,1,5,5,10,f,Kay.jpg,pieFS1.bmp,Kay just won the lottery,1,resources,793319,816494,23175,q,1
220758,47,3,4,9,13,m,Daniel.jpg,pieFS3.bmp,Daniel employs illegal immigrants and pays them less than minimum wage.,1,reputation,828684,839138,10454,q,1
220758,48,3,3,7,10,f,Jackie.jpg,pieFS3.bmp,Jackie steals her coworkers' tips to buy alcohol.,1,reputation,851340,858698,7358,q,1
220758,49,5,1,9,10,m,Ian.jpg,pieFS5.bmp,Ian is saving to pay his university fees,2,na,870870,872404,1534,q,1
220758,50,2,6,9,15,m,Darnell.jpg,pieFS2.bmp,Darnell lives in a luxury penthouse apartment,1,resources,884598,886503,1905,q,1
220758,51,5,1,9,10,f,Fay.jpg,pieFS5.bmp,Fay cannot afford to send her son to college.,2,na,898694,899999,1305,q,1
220758,52,5,1,9,10,f,Cindy.jpg,pieFS5.bmp,Cindy just lost her small business after a franchise moved in next door.,2,na,912204,914872,2668,q,1
220772,1,3,5,11,16,f,Sharon.jpg,pieFS3.bmp,Sharon claims false expenses for her reportable work travel.,1,reputation,22647,27927,5280,p,0
220772,2,3,2,4,6,f,Beth.jpg,pieFS3.bmp,Beth works as a cleaner in a hotel,2,na,40120,43442,3322,q,1
220772,3,5,1,9,10,m,Mark.jpg,pieFS5.bmp,Mark is saving to pay his university fees,2,na,55621,59803,4182,q,1
220772,4,3,3,7,10,f,Monica.jpg,pieFS3.bmp,Monica used her mother's social security number to open a credit card account.,1,reputation,71974,75664,3690,p,0
220772,5,5,1,9,10,f,Fiona.jpg,pieFS5.bmp,Fiona's husband is a wealthy investment banker,1,resources,87858,94399,6541,p,0
220772,6,2,3,4,7,m,Taymar.jpg,pieFS2.bmp,Taymar is a retiree,2,na,106619,108165,1546,q,1
220772,7,4,2,8,10,m,Justin.jpg,pieFS4.bmp,Justin just bought an expensive sports car,1,resources,120364,123556,3192,p,0
220772,8,5,1,9,10,f,Trish.jpg,pieFS5.bmp,Trish can't afford to pay her medical bills,2,na,135747,138448,2701,q,1
220772,9,5,1,9,10,f,Marny.jpg,pieFS5.bmp,Marny is raising money to buy gifts for children in need.,2,na,150645,154091,3446,q,1
220772,10,3,6,14,20,m,Paul.jpg,pieFS3.bmp,Paul is saving for his son's operation,2,na,166263,167825,1562,q,1
220772,11,3,3,7,10,f,Fay.jpg,pieFS3.bmp,Fay is going to be evicted because she is behind on her rent,2,na,180007,181731,1724,q,1
220772,12,5,1,9,10,m,Ian.jpg,pieFS5.bmp,Ian lives in a luxury penthouse apartment,1,resources,193886,195107,1221,p,0
220772,13,2,3,4,7,f,Deborah.jpg,pieFS2.bmp,Deborah illegally parks in the disabled parking spots when she can.,1,reputation,207279,208360,1081,p,0
220772,14,3,4,9,13,m,George.jpg,pieFS3.bmp,George bullies his employees to put in extra hours at work.,1,reputation,220555,221599,1044,p,0
220772,15,5,2,18,20,m,Peter.jpg,pieFS5.bmp,Peter stole money from his mother's wallet.,1,reputation,233765,234348,583,p,0
220772,16,4,2,8,10,f,Kelly.jpg,pieFS4.bmp,Kelly's car with her bag and credit cards was recently stolen.,2,na,246506,249441,2935,q,1
220772,17,4,3,12,15,m,Darnell.jpg,pieFS4.bmp,Darnell lost his life savings when his small business failed,2,na,261639,262785,1146,q,1
220772,18,5,1,9,10,f,Emily.jpg,pieFS5.bmp,Emily just found out that her husband has incurred a large credit card debt.,2,na,274982,276798,1816,q,1
220772,19,4,3,12,15,m,Stuart.jpg,pieFS4.bmp,Stuart cheated on his taxes and is now under investigation for tax fraud.,1,reputation,288994,289977,983,p,0
220772,20,5,2,18,20,f,Kay.jpg,pieFS5.bmp,Kay owns an international company,1,resources,302170,305178,3008,p,0
220772,21,5,2,18,20,m,Daniel.jpg,pieFS5.bmp,Daniel just lost his job,2,na,317369,318335,966,q,1
220772,22,4,1,4,5,m,Don.jpg,pieFS4.bmp,Don is a veteran having trouble finding employment.,2,na,330529,331726,1197,q,1
220772,23,4,1,4,5,m,Ben.jpg,pieFS4.bmp,Ben stole his elderly father's prescription medications.,1,reputation,343872,345321,1449,p,0
220772,24,5,1,9,10,f,Lauren.jpg,pieFS5.bmp,Lauren is a highly paid actress,1,resources,357500,358743,1243,p,0
220772,25,5,2,18,20,m,Jack.jpg,pieFS5.bmp,Jack declared bankruptcy after he was laid off.,2,na,370943,372044,1101,p,0
220772,26,1,10,10,20,f,Jean.jpg,pieFS1.bmp,Jean has to take an unpaid leave of absence because her mother broke her hip.,2,na,384253,385889,1636,q,1
220772,27,3,4,9,13,m,Tony.jpg,pieFS3.bmp,Tony takes valuables from his friends' homes when asked to house-sit.,1,reputation,398081,398555,474,p,0
220772,28,2,8,12,20,f,Mary.jpg,pieFS2.bmp,Mary received a large inheritance from a distant relative,1,resources,410756,413781,3025,q,1
220772,29,2,7,10,17,f,Arianna.jpg,pieFS2.bmp,Arianna is a single mother,2,na,425972,427438,1466,q,1
220772,30,4,4,16,20,f,Miriam.jpg,pieFS4.bmp,Miriam just won the lottery,1,resources,439633,442673,3040,q,1
220772,31,5,1,9,10,f,Eileen.jpg,pieFS5.bmp,Eileen got a large cash bonus from her boss,1,resources,454832,458102,3270,p,0
220772,32,4,2,8,10,f,Jenny.jpg,pieFS4.bmp,Jenny was a victim of identity theft and is now thousands of dollars in debt.,2,na,470265,472706,2441,q,1
220772,33,3,2,4,6,f,Janet.jpg,pieFS3.bmp,Janet cannot afford to send her son to college.,2,na,484896,486769,1873,q,1
220772,34,3,6,14,20,m,Saul.jpg,pieFS3.bmp,Saul was injured in a hit-and-run accident and cannot afford his medical bills.,2,na,498958,500316,1358,q,1
220772,35,5,2,18,20,m,Joe.jpg,pieFS5.bmp,Joe employs illegal immigrants and pays them less than minimum wage.,1,reputation,512519,512645,126,p,0
220772,36,2,6,9,15,m,Brad.jpg,pieFS2.bmp,Brad was mugged and had his wallet stolen.,2,na,524842,527052,2210,q,1
220772,37,4,1,4,5,f,Maria.jpg,pieFS4.bmp,Maria works two waitressing jobs to pay her bills.,2,na,539239,540553,1314,q,1
220772,38,4,3,12,15,f,Cindy.jpg,pieFS4.bmp,Cindy just received a huge cash settlement,1,resources,552749,554663,1914,q,1
220772,39,3,2,4,6,f,Louise.jpg,pieFS3.bmp,Louise regularly fires employees to avoid promoting them.,1,reputation,566845,568386,1541,p,0
220772,40,4,4,16,20,m,Alan.jpg,pieFS4.bmp,Alan could not afford his mortgage and his home was foreclosed.,2,na,580539,581736,1197,q,1
220772,41,1,9,9,18,m,Edward.jpg,pieFS1.bmp,Edward is hiding his taxable income in Switzerland.,1,reputation,593933,595196,1263,p,0
220772,42,3,2,4,6,f,Jackie.jpg,pieFS3.bmp,Jackie takes discarded food from grocery stores to feed her children.,2,na,607393,610744,3351,q,1
220772,43,3,4,9,13,m,Jared.jpg,pieFS3.bmp,Jared underreports his company's earnings and pockets the profits.,1,reputation,622910,625009,2099,p,0
220772,44,1,5,5,10,f,Joanna.jpg,pieFS1.bmp,Joanna steals her coworkers' tips to buy alcohol.,1,reputation,637207,638133,926,p,0
220772,45,2,6,9,15,m,Kevin.jpg,pieFS2.bmp,Kevin often goes through and steals the neighbors' mail.,1,reputation,650332,650339,7,p,0
220772,46,1,8,8,16,m,Nick.jpg,pieFS1.bmp,Nick has been unable to find a job for over a year.,2,na,662555,666481,3926,q,1
220772,47,3,5,11,16,m,Matt.jpg,pieFS3.bmp,Matt lost his house in a fire,2,na,678674,679748,1074,q,1
220772,48,4,2,8,10,m,Sam.jpg,pieFS4.bmp,Sam just found $50 on the street,1,resources,691968,695300,3332,q,1
220772,49,5,1,9,10,m,Michael.jpg,pieFS5.bmp,Michael is homeless,2,na,707485,709577,2092,q,1
220772,50,4,3,12,15,f,Sammy.jpg,pieFS4.bmp,Sammy just lost her small business after a franchise moved in next door.,2,na,721781,723287,1506,q,1
220772,51,4,4,16,20,f,Emma.jpg,pieFS4.bmp,Emma secretly gambles with her husband's savings.,1,reputation,735492,736476,984,p,0
220772,52,3,3,7,10,m,Ricky.jpg,pieFS3.bmp,Ricky is a well paid lawyer,1,resources,748668,754430,5762,q,1
220789,1,3,2,4,6,f,Fay.jpg,pieFS3.bmp,Fay works as a cleaner in a hotel,2,na,54844,57422,2578,q,1
220789,2,4,4,16,20,f,Monica.jpg,pieFS4.bmp,Monica is a highly paid actress,1,resources,69608,78290,8682,q,1
220789,3,3,4,9,13,m,Darnell.jpg,pieFS3.bmp,Darnell lives in a luxury penthouse apartment,1,resources,90509,92497,1988,q,1
220789,4,4,3,12,15,f,Sharon.jpg,pieFS4.bmp,Sharon's husband is a wealthy investment banker,1,resources,104689,106920,2231,q,1
220789,5,1,10,10,20,f,Fiona.jpg,pieFS1.bmp,Fiona can't afford to pay her medical bills,2,na,119119,121057,1938,q,1
220789,6,5,2,18,20,m,Saul.jpg,pieFS5.bmp,Saul stole money from his mother's wallet.,1,reputation,133265,135926,2661,p,0
220789,7,4,3,12,15,f,Joanna.jpg,pieFS4.bmp,Joanna has to take an unpaid leave of absence because her mother broke her hip.,2,na,148130,150133,2003,q,1
220789,8,3,4,9,13,m,Justin.jpg,pieFS3.bmp,Justin employs illegal immigrants and pays them less than minimum wage.,1,reputation,162292,164682,2390,p,0
220789,9,5,2,18,20,m,Joe.jpg,pieFS5.bmp,Joe could not afford his mortgage and his home was foreclosed.,2,na,176873,178711,1838,q,1
220789,10,2,6,9,15,m,Ricky.jpg,pieFS2.bmp,Ricky is hiding his taxable income in Switzerland.,1,reputation,190918,192980,2062,p,0
220789,11,3,3,7,10,f,Cindy.jpg,pieFS3.bmp,Cindy got a large cash bonus from her boss,1,resources,205181,207004,1823,q,1
220789,12,5,1,9,10,m,Matt.jpg,pieFS5.bmp,Matt lost his life savings when his small business failed,2,na,219177,221179,2002,q,1
220789,13,3,2,4,6,f,Trish.jpg,pieFS3.bmp,Trish is going to be evicted because she is behind on her rent,2,na,233356,234903,1547,q,1
220789,14,5,1,9,10,f,Janet.jpg,pieFS5.bmp,Janet owns an international company,1,resources,247084,249059,1975,q,1
220789,15,5,2,18,20,m,Nick.jpg,pieFS5.bmp,Nick cheated on his taxes and is now under investigation for tax fraud.,1,reputation,261230,267208,5978,p,0
220789,16,2,7,10,17,f,Jackie.jpg,pieFS2.bmp,Jackie was a victim of identity theft and is now thousands of dollars in debt.,2,na,279405,281177,1772,q,1
220789,17,5,1,9,10,m,Ben.jpg,pieFS5.bmp,Ben is a veteran having trouble finding employment.,2,na,293367,295201,1834,q,1
220789,18,4,4,16,20,f,Kay.jpg,pieFS4.bmp,Kay received a large inheritance from a distant relative,1,resources,307363,309338,1975,q,1
220789,19,5,1,9,10,m,Tony.jpg,pieFS5.bmp,Tony stole his elderly father's prescription medications.,1,reputation,321542,324000,2458,p,0
220789,20,3,6,14,20,m,Michael.jpg,pieFS3.bmp,Michael declared bankruptcy after he was laid off.,2,na,336139,337682,1543,q,1
220789,21,4,2,8,10,m,Jack.jpg,pieFS4.bmp,Jack takes valuables from his friends' homes when asked to house-sit.,1,reputation,349834,351674,1840,p,0
220789,22,3,4,9,13,m,Daniel.jpg,pieFS3.bmp,Daniel underreports his company's earnings and pockets the profits.,1,reputation,363846,365360,1514,p,0
220789,23,3,3,7,10,f,Kelly.jpg,pieFS3.bmp,Kelly works two waitressing jobs to pay her bills.,2,na,377557,379161,1604,q,1
220789,24,4,1,4,5,f,Louise.jpg,pieFS4.bmp,Louise is a single mother,2,na,391335,394624,3289,q,1
220789,25,3,2,4,6,f,Jean.jpg,pieFS3.bmp,Jean just received a huge cash settlement,1,resources,406802,408635,1833,q,1
220789,26,1,8,8,16,m,Peter.jpg,pieFS1.bmp,Peter was injured in a hit-and-run accident and cannot afford his medical bills.,2,na,420814,422602,1788,q,1
220789,27,4,2,8,10,f,Jenny.jpg,pieFS4.bmp,Jenny takes discarded food from grocery stores to feed her children.,2,na,434776,436664,1888,q,1
220789,28,3,5,11,16,m,Mark.jpg,pieFS3.bmp,Mark was mugged and had his wallet stolen.,2,na,448855,451659,2804,q,1
220789,29,2,3,4,7,f,Arianna.jpg,pieFS2.bmp,Arianna just won the lottery,1,resources,463853,465988,2135,q,1
220789,30,3,5,11,16,f,Deborah.jpg,pieFS3.bmp,Deborah steals her coworkers' tips to buy alcohol.,1,reputation,478183,479882,1699,p,0
220789,31,5,1,9,10,f,Eileen.jpg,pieFS5.bmp,Eileen just lost her small business after a franchise moved in next door.,2,na,492061,493643,1582,q,1
220789,32,1,9,9,18,m,Don.jpg,pieFS1.bmp,Don often goes through and steals the neighbors' mail.,1,reputation,505806,507401,1595,p,0
220789,33,3,3,7,10,m,Alan.jpg,pieFS3.bmp,Alan is a well paid lawyer,1,resources,519601,521468,1867,q,1
220789,34,4,1,4,5,m,Paul.jpg,pieFS4.bmp,Paul is a retiree,2,na,533663,535773,2110,q,1
220789,35,5,2,18,20,f,Lauren.jpg,pieFS5.bmp,Lauren used her mother's social security number to open a credit card account.,1,reputation,547959,549479,1520,p,0
220789,36,4,2,8,10,f,Marny.jpg,pieFS4.bmp,Marny is raising money to buy gifts for children in need.,2,na,561670,563335,1665,q,1
220789,37,4,2,8,10,m,George.jpg,pieFS4.bmp,George just bought an expensive sports car,1,resources,575515,577092,1577,q,1
220789,38,4,4,16,20,m,Edward.jpg,pieFS4.bmp,Edward is saving for his son's operation,2,na,589276,592603,3327,q,1
220789,39,5,2,18,20,m,Sam.jpg,pieFS5.bmp,Sam has been unable to find a job for over a year.,2,na,604793,607734,2941,q,1
220789,40,3,2,4,6,f,Beth.jpg,pieFS3.bmp,Beth cannot afford to send her son to college.,2,na,619909,622039,2130,q,1
220789,41,2,6,9,15,m,Kevin.jpg,pieFS2.bmp,Kevin lost his house in a fire,2,na,634222,636003,1781,q,1
220789,42,4,1,4,5,m,Taymar.jpg,pieFS4.bmp,Taymar bullies his employees to put in extra hours at work.,1,reputation,648201,649506,1305,p,0
220789,43,4,3,12,15,m,Stuart.jpg,pieFS4.bmp,Stuart just found $50 on the street,1,resources,661695,663438,1743,q,1
220789,44,2,8,12,20,f,Mary.jpg,pieFS2.bmp,Mary regularly fires employees to avoid promoting them.,1,reputation,675640,678381,2741,p,0
220789,45,1,5,5,10,f,Emma.jpg,pieFS1.bmp,Emma secretly gambles with her husband's savings.,1,reputation,690555,692625,2070,p,0
220789,46,5,1,9,10,f,Sammy.jpg,pieFS5.bmp,Sammy illegally parks in the disabled parking spots when she can.,1,reputation,704818,706673,1855,q,1
220789,47,5,1,9,10,f,Miriam.jpg,pieFS5.bmp,Miriam claims false expenses for her reportable work travel.,1,reputation,718863,720267,1404,p,0
220789,48,3,6,14,20,m,Jared.jpg,pieFS3.bmp,Jared just lost his job,2,na,732441,734198,1757,q,1
220789,49,5,1,9,10,f,Maria.jpg,pieFS5.bmp,Maria's car with her bag and credit cards was recently stolen.,2,na,746386,747866,1480,q,1
220789,50,2,3,4,7,m,Ian.jpg,pieFS2.bmp,Ian is homeless,2,na,760047,762023,1976,q,1
220789,51,5,1,9,10,f,Emily.jpg,pieFS5.bmp,Emily just found out that her husband has incurred a large credit card debt.,2,na,774176,775540,1364,q,1
220789,52,4,3,12,15,m,Brad.jpg,pieFS4.bmp,Brad is saving to pay his university fees,2,na,787737,789358,1621,q,1
220796,1,5,1,9,10,f,Deborah.jpg,pieFS5.bmp,Deborah just received a huge cash settlement,1,resources,63822,69861,6039,p,0
220796,2,4,3,12,15,m,Sam.jpg,pieFS4.bmp,Sam takes valuables from his friends' homes when asked to house-sit.,1,reputation,82031,84411,2380,p,0
220796,3,2,3,4,7,m,Taymar.jpg,pieFS2.bmp,Taymar just lost his job,2,na,96612,123578,26966,q,1
220796,4,3,2,4,6,f,Jean.jpg,pieFS3.bmp,Jean takes discarded food from grocery stores to feed her children.,2,na,135772,138502,2730,q,1
220796,5,5,2,18,20,m,Paul.jpg,pieFS5.bmp,Paul employs illegal immigrants and pays them less than minimum wage.,1,reputation,150687,153577,2890,p,0
220796,6,3,6,14,20,m,Daniel.jpg,pieFS3.bmp,Daniel could not afford his mortgage and his home was foreclosed.,2,na,165769,168595,2826,q,1
220796,7,3,5,11,16,f,Jenny.jpg,pieFS3.bmp,Jenny steals her coworkers' tips to buy alcohol.,1,reputation,180768,183408,2640,p,0
220796,8,3,2,4,6,f,Emma.jpg,pieFS3.bmp,Emma claims false expenses for her reportable work travel.,1,reputation,195599,197695,2096,p,0
220796,9,5,1,9,10,f,Trish.jpg,pieFS5.bmp,Trish works as a cleaner in a hotel,2,na,209862,215319,5457,q,1
220796,10,3,6,14,20,m,Mark.jpg,pieFS3.bmp,Mark was injured in a hit-and-run accident and cannot afford his medical bills.,2,na,227486,230093,2607,q,1
220796,11,2,6,9,15,m,Matt.jpg,pieFS2.bmp,Matt was mugged and had his wallet stolen.,2,na,242267,244417,2150,q,1
220796,12,3,4,9,13,m,Don.jpg,pieFS3.bmp,Don often goes through and steals the neighbors' mail.,1,reputation,256580,258986,2406,p,0
220796,13,4,4,16,20,f,Janet.jpg,pieFS4.bmp,Janet's husband is a wealthy investment banker,1,resources,271178,273366,2188,q,1
220796,14,4,2,8,10,f,Sharon.jpg,pieFS4.bmp,Sharon can't afford to pay her medical bills,2,na,285541,287480,1939,q,1
220796,15,4,1,4,5,m,Michael.jpg,pieFS4.bmp,Michael has been unable to find a job for over a year.,2,na,299653,303291,3638,q,1
220796,16,3,2,4,6,f,Monica.jpg,pieFS3.bmp,Monica just lost her small business after a franchise moved in next door.,2,na,315488,317427,1939,q,1
220796,17,5,2,18,20,f,Cindy.jpg,pieFS5.bmp,Cindy used her mother's social security number to open a credit card account.,1,reputation,329617,331695,2078,p,0
220796,18,4,1,4,5,m,Alan.jpg,pieFS4.bmp,Alan is hiding his taxable income in Switzerland.,1,reputation,343863,346765,2902,p,0
220796,19,3,3,7,10,m,Jared.jpg,pieFS3.bmp,Jared underreports his company's earnings and pockets the profits.,1,reputation,358962,360832,1870,p,0
220796,20,5,1,9,10,f,Fay.jpg,pieFS5.bmp,Fay is going to be evicted because she is behind on her rent,2,na,373024,375288,2264,q,1
220796,21,5,2,18,20,m,Jack.jpg,pieFS5.bmp,Jack lost his house in a fire,2,na,387488,392987,5499,q,1
220796,22,1,10,10,20,f,Sammy.jpg,pieFS1.bmp,Sammy is raising money to buy gifts for children in need.,2,na,405179,412336,7157,q,1
220796,23,5,1,9,10,f,Miriam.jpg,pieFS5.bmp,Miriam owns an international company,1,resources,424508,426717,2209,p,0
220796,24,3,4,9,13,m,Nick.jpg,pieFS3.bmp,Nick just found $50 on the street,1,resources,438905,442748,3843,q,1
220796,25,4,4,16,20,m,Darnell.jpg,pieFS4.bmp,Darnell is homeless,2,na,454940,460501,5561,q,1
220796,26,1,8,8,16,m,Ian.jpg,pieFS1.bmp,Ian is saving to pay his university fees,2,na,472698,476140,3442,q,1
220796,27,4,3,12,15,f,Maria.jpg,pieFS4.bmp,Maria illegally parks in the disabled parking spots when she can.,1,reputation,488315,490559,2244,p,0
220796,28,5,1,9,10,m,George.jpg,pieFS5.bmp,George is a well paid lawyer,1,resources,502728,505070,2342,p,0
220796,29,4,2,8,10,m,Brad.jpg,pieFS4.bmp,Brad lives in a luxury penthouse apartment,1,resources,517242,519334,2092,p,0
220796,30,1,9,9,18,m,Saul.jpg,pieFS1.bmp,Saul stole money from his mother's wallet.,1,reputation,531522,539082,7560,p,0
220796,31,5,1,9,10,m,Ricky.jpg,pieFS5.bmp,Ricky is a retiree,2,na,551269,554307,3038,p,0
220796,32,5,2,18,20,m,Joe.jpg,pieFS5.bmp,Joe just bought an expensive sports car,1,resources,566485,568406,1921,p,0
220796,33,5,1,9,10,f,Eileen.jpg,pieFS5.bmp,Eileen's car with her bag and credit cards was recently stolen.,2,na,580564,592817,12253,p,0
220796,34,3,2,4,6,f,Emily.jpg,pieFS3.bmp,Emily just found out that her husband has incurred a large credit card debt.,2,na,604993,618822,13829,p,0
220796,35,5,2,18,20,m,Tony.jpg,pieFS5.bmp,Tony lost his life savings when his small business failed,2,na,630994,637117,6123,q,1
220796,36,3,4,9,13,m,Stuart.jpg,pieFS3.bmp,Stuart cheated on his taxes and is now under investigation for tax fraud.,1,reputation,649304,655084,5780,q,1
220796,37,3,5,11,16,m,Edward.jpg,pieFS3.bmp,Edward is saving for his son's operation,2,na,667245,672240,4995,q,1
220796,38,5,1,9,10,m,Peter.jpg,pieFS5.bmp,Peter is a veteran having trouble finding employment.,2,na,684417,687052,2635,q,1
220796,39,3,3,7,10,f,Kay.jpg,pieFS3.bmp,Kay received a large inheritance from a distant relative,1,resources,699232,702290,3058,q,1
220796,40,2,6,9,15,m,Ben.jpg,pieFS2.bmp,Ben stole his elderly father's prescription medications.,1,reputation,714465,718700,4235,p,0
220796,41,4,2,8,10,f,Mary.jpg,pieFS4.bmp,Mary is a single mother,2,na,730885,734056,3171,q,1
220796,42,2,3,4,7,f,Joanna.jpg,pieFS2.bmp,Joanna is a highly paid actress,1,resources,746218,749936,3718,q,1
220796,43,4,2,8,10,m,Justin.jpg,pieFS4.bmp,Justin bullies his employees to put in extra hours at work.,1,reputation,762119,764219,2100,p,0
220796,44,2,7,10,17,f,Jackie.jpg,pieFS2.bmp,Jackie has to take an unpaid leave of absence because her mother broke her hip.,2,na,776399,780593,4194,q,1
220796,45,1,5,5,10,f,Louise.jpg,pieFS1.bmp,Louise just won the lottery,1,resources,792769,794973,2204,q,1
220796,46,5,1,9,10,f,Kelly.jpg,pieFS5.bmp,Kelly got a large cash bonus from her boss,1,resources,807165,809840,2675,p,0
220796,47,3,3,7,10,f,Lauren.jpg,pieFS3.bmp,Lauren was a victim of identity theft and is now thousands of dollars in debt.,2,na,822014,824760,2746,q,1
220796,48,4,3,12,15,f,Beth.jpg,pieFS4.bmp,Beth cannot afford to send her son to college.,2,na,836962,840121,3159,q,1
220796,49,4,4,16,20,f,Arianna.jpg,pieFS4.bmp,Arianna regularly fires employees to avoid promoting them.,1,reputation,852312,856301,3989,p,0
220796,50,2,8,12,20,f,Fiona.jpg,pieFS2.bmp,Fiona secretly gambles with her husband's savings.,1,reputation,868498,873664,5166,p,0
220796,51,4,1,4,5,f,Marny.jpg,pieFS4.bmp,Marny works two waitressing jobs to pay her bills.,2,na,885854,888813,2959,q,1
220796,52,4,3,12,15,m,Kevin.jpg,pieFS4.bmp,Kevin declared bankruptcy after he was laid off.,2,na,901003,903381,2378,q,1
220865,1,5,1,9,10,m,Sam.jpg,pieFS5.bmp,Sam lost his house in a fire,2,na,157978,161542,3564,q,1
220865,2,3,4,9,13,m,Matt.jpg,pieFS3.bmp,Matt just found $50 on the street,1,resources,173794,175142,1348,q,1
220865,3,4,1,4,5,f,Eileen.jpg,pieFS4.bmp,Eileen works two waitressing jobs to pay her bills.,2,na,187396,188322,926,q,1
220865,4,3,6,14,20,m,Stuart.jpg,pieFS3.bmp,Stuart is homeless,2,na,200548,201783,1235,q,1
220865,5,4,4,16,20,m,Brad.jpg,pieFS4.bmp,Brad is saving to pay his university fees,2,na,214016,218903,4887,q,1
220865,6,4,2,8,10,m,Nick.jpg,pieFS4.bmp,Nick lives in a luxury penthouse apartment,1,resources,231130,232023,893,q,1
220865,7,5,1,9,10,m,Joe.jpg,pieFS5.bmp,Joe bullies his employees to put in extra hours at work.,1,reputation,244249,245043,794,q,1
220865,8,3,5,11,16,f,Monica.jpg,pieFS3.bmp,Monica just received a huge cash settlement,1,resources,257268,258144,876,q,1
220865,9,5,1,9,10,m,Edward.jpg,pieFS5.bmp,Edward just lost his job,2,na,270354,271084,730,q,1
220865,10,4,2,8,10,f,Beth.jpg,pieFS4.bmp,Beth cannot afford to send her son to college.,2,na,283306,284664,1358,q,1
220865,11,3,2,4,6,f,Sammy.jpg,pieFS3.bmp,Sammy takes discarded food from grocery stores to feed her children.,2,na,296891,298105,1214,q,1
220865,12,3,2,4,6,f,Jean.jpg,pieFS3.bmp,Jean steals her coworkers' tips to buy alcohol.,1,reputation,310326,311285,959,q,1
220865,13,3,4,9,13,m,Jared.jpg,pieFS3.bmp,Jared employs illegal immigrants and pays them less than minimum wage.,1,reputation,323511,325445,1934,q,1
220865,14,2,6,9,15,m,Paul.jpg,pieFS2.bmp,Paul could not afford his mortgage and his home was foreclosed.,2,na,337696,338705,1009,q,1
220865,15,2,6,9,15,m,Ben.jpg,pieFS2.bmp,Ben stole money from his mother's wallet.,1,reputation,350931,352066,1135,q,1
220865,16,1,9,9,18,m,George.jpg,pieFS1.bmp,George is hiding his taxable income in Switzerland.,1,reputation,364299,365466,1167,q,1
220865,17,4,1,4,5,m,Michael.jpg,pieFS4.bmp,Michael lost his life savings when his small business failed,2,na,377684,378666,982,q,1
220865,18,3,4,9,13,m,Jack.jpg,pieFS3.bmp,Jack cheated on his taxes and is now under investigation for tax fraud.,1,reputation,390887,392106,1219,q,1
220865,19,3,3,7,10,f,Trish.jpg,pieFS3.bmp,Trish regularly fires employees to avoid promoting them.,1,reputation,404322,405147,825,q,1
220865,20,5,1,9,10,f,Miriam.jpg,pieFS5.bmp,Miriam secretly gambles with her husband's savings.,1,reputation,417374,418227,853,q,1
220865,21,3,3,7,10,f,Kelly.jpg,pieFS3.bmp,Kelly just lost her small business after a franchise moved in next door.,2,na,430459,431467,1008,q,1
220865,22,5,1,9,10,f,Maria.jpg,pieFS5.bmp,Maria used her mother's social security number to open a credit card account.,1,reputation,443678,452107,8429,q,1
220865,23,3,6,14,20,m,Tony.jpg,pieFS3.bmp,Tony is a veteran having trouble finding employment.,2,na,464338,465548,1210,q,1
220865,24,3,3,7,10,m,Saul.jpg,pieFS3.bmp,Saul stole his elderly father's prescription medications.,1,reputation,477790,479568,1778,q,1
220865,25,5,2,18,20,m,Peter.jpg,pieFS5.bmp,Peter declared bankruptcy after he was laid off.,2,na,491808,492348,540,q,1
220865,26,4,4,16,20,f,Emma.jpg,pieFS4.bmp,Emma claims false expenses for her reportable work travel.,1,reputation,504577,505589,1012,q,1
220865,27,3,2,4,6,f,Mary.jpg,pieFS3.bmp,Mary works as a cleaner in a hotel,2,na,517812,519329,1517,q,1
220865,28,5,1,9,10,f,Emily.jpg,pieFS5.bmp,Emily is raising money to buy gifts for children in need.,2,na,531564,534009,2445,q,1
220865,29,4,3,12,15,m,Ian.jpg,pieFS4.bmp,Ian takes valuables from his friends' homes when asked to house-sit.,1,reputation,546231,547069,838,q,1
220865,30,5,2,18,20,f,Louise.jpg,pieFS5.bmp,Louise's husband is a wealthy investment banker,1,resources,559283,560110,827,q,1
220865,31,2,3,4,7,f,Lauren.jpg,pieFS2.bmp,Lauren illegally parks in the disabled parking spots when she can.,1,reputation,572335,574450,2115,p,0
220865,32,5,2,18,20,m,Darnell.jpg,pieFS5.bmp,Darnell was injured in a hit-and-run accident and cannot afford his medical bills.,2,na,586669,587550,881,q,1
220865,33,5,1,9,10,f,Kay.jpg,pieFS5.bmp,Kay can't afford to pay her medical bills,2,na,599771,601490,1719,q,1
220865,34,4,3,12,15,f,Janet.jpg,pieFS4.bmp,Janet is going to be evicted because she is behind on her rent,2,na,613723,614831,1108,q,1
220865,35,4,3,12,15,f,Sharon.jpg,pieFS4.bmp,Sharon owns an international company,1,resources,627058,628151,1093,q,1
220865,36,1,8,8,16,m,Don.jpg,pieFS1.bmp,Don was mugged and had his wallet stolen.,2,na,640376,641371,995,q,1
220865,37,2,7,10,17,f,Cindy.jpg,pieFS2.bmp,Cindy's car with her bag and credit cards was recently stolen.,2,na,653595,655171,1576,q,1
220865,38,4,2,8,10,m,Daniel.jpg,pieFS4.bmp,Daniel underreports his company's earnings and pockets the profits.,1,reputation,667396,668412,1016,q,1
220865,39,5,2,18,20,m,Mark.jpg,pieFS5.bmp,Mark often goes through and steals the neighbors' mail.,1,reputation,680632,681852,1220,q,1
220865,40,1,10,10,20,f,Joanna.jpg,pieFS1.bmp,Joanna just found out that her husband has incurred a large credit card debt.,2,na,694083,695032,949,q,1
220865,41,1,5,5,10,f,Jackie.jpg,pieFS1.bmp,Jackie is a highly paid actress,1,resources,707235,708433,1198,q,1
220865,42,5,2,18,20,m,Ricky.jpg,pieFS5.bmp,Ricky is a well paid lawyer,1,resources,720654,721813,1159,q,1
220865,43,3,2,4,6,f,Deborah.jpg,pieFS3.bmp,Deborah has to take an unpaid leave of absence because her mother broke her hip.,2,na,734039,734933,894,q,1
220865,44,4,4,16,20,f,Arianna.jpg,pieFS4.bmp,Arianna received a large inheritance from a distant relative,1,resources,747141,748413,1272,q,1
220865,45,2,8,12,20,f,Marny.jpg,pieFS2.bmp,Marny got a large cash bonus from her boss,1,resources,760643,768754,8111,q,1
220865,46,3,5,11,16,m,Taymar.jpg,pieFS3.bmp,Taymar is a retiree,2,na,780970,781654,684,q,1
220865,47,2,3,4,7,m,Kevin.jpg,pieFS2.bmp,Kevin has been unable to find a job for over a year.,2,na,793873,795014,1141,q,1
220865,48,4,1,4,5,m,Alan.jpg,pieFS4.bmp,Alan just bought an expensive sports car,1,resources,807241,808234,993,q,1
220865,49,4,2,8,10,f,Fiona.jpg,pieFS4.bmp,Fiona is a single mother,2,na,820443,821275,832,q,1
220865,50,5,1,9,10,f,Fay.jpg,pieFS5.bmp,Fay just won the lottery,1,resources,833495,834575,1080,q,1
220865,51,5,1,9,10,f,Jenny.jpg,pieFS5.bmp,Jenny was a victim of identity theft and is now thousands of dollars in debt.,2,na,846797,848815,2018,q,1
220865,52,4,3,12,15,m,Justin.jpg,pieFS4.bmp,Justin is saving for his son's operation,2,na,861031,862676,1645,q,1
220908,1,1,9,9,18,m,Michael.jpg,pieFS1.bmp,Michael takes valuables from his friends' homes when asked to house-sit.,1,reputation,91791,95972,4181,p,0
220908,2,4,1,4,5,m,Brad.jpg,pieFS4.bmp,Brad was injured in a hit-and-run accident and cannot afford his medical bills.,2,na,108239,112933,4694,q,1
220908,3,4,2,8,10,f,Fay.jpg,pieFS4.bmp,Fay is going to be evicted because she is behind on her rent,2,na,125203,128432,3229,q,1
220908,4,5,1,9,10,f,Kelly.jpg,pieFS5.bmp,Kelly just received a huge cash settlement,1,resources,140703,148272,7569,p,0
220908,5,5,2,18,20,f,Fiona.jpg,pieFS5.bmp,Fiona owns an international company,1,resources,160547,169792,9245,p,0
220908,6,5,1,9,10,f,Jackie.jpg,pieFS5.bmp,Jackie takes discarded food from grocery stores to feed her children.,2,na,182073,185072,2999,q,1
220908,7,3,6,14,20,m,Jack.jpg,pieFS3.bmp,Jack was mugged and had his wallet stolen.,2,na,197356,199412,2056,q,1
220908,8,1,5,5,10,f,Sharon.jpg,pieFS1.bmp,Sharon received a large inheritance from a distant relative,1,resources,211689,214153,2464,q,1
220908,9,2,6,9,15,m,Darnell.jpg,pieFS2.bmp,Darnell often goes through and steals the neighbors' mail.,1,reputation,226423,228653,2230,p,0
220908,10,4,4,16,20,f,Cindy.jpg,pieFS4.bmp,Cindy steals her coworkers' tips to buy alcohol.,1,reputation,240923,242653,1730,p,0
220908,11,3,2,4,6,f,Louise.jpg,pieFS3.bmp,Louise is a single mother,2,na,254924,257153,2229,q,1
220908,12,4,4,16,20,m,Saul.jpg,pieFS4.bmp,Saul has been unable to find a job for over a year.,2,na,269425,271433,2008,q,1
220908,13,3,2,4,6,f,Sammy.jpg,pieFS3.bmp,Sammy just lost her small business after a franchise moved in next door.,2,na,283709,285733,2024,q,1
220908,14,5,1,9,10,m,Joe.jpg,pieFS5.bmp,Joe could not afford his mortgage and his home was foreclosed.,2,na,298009,299813,1804,q,1
220908,15,3,2,4,6,f,Marny.jpg,pieFS3.bmp,Marny used her mother's social security number to open a credit card account.,1,reputation,312093,314133,2040,p,0
220908,16,3,3,7,10,f,Monica.jpg,pieFS3.bmp,Monica is raising money to buy gifts for children in need.,2,na,326411,328133,1722,q,1
220908,17,2,3,4,7,f,Trish.jpg,pieFS2.bmp,Trish just won the lottery,1,resources,340378,344033,3655,q,1
220908,18,3,2,4,6,f,Arianna.jpg,pieFS3.bmp,Arianna cannot afford to send her son to college.,2,na,356260,358193,1933,q,1
220908,19,4,3,12,15,m,Taymar.jpg,pieFS4.bmp,Taymar is hiding his taxable income in Switzerland.,1,reputation,370444,372533,2089,p,0
220908,20,5,2,18,20,m,Paul.jpg,pieFS5.bmp,Paul underreports his company's earnings and pockets the profits.,1,reputation,384812,386693,1881,p,0
220908,21,2,3,4,7,m,Sam.jpg,pieFS2.bmp,Sam lost his house in a fire,2,na,398946,401053,2107,q,1
220908,22,3,3,7,10,m,Edward.jpg,pieFS3.bmp,Edward is a well paid lawyer,1,resources,413329,418073,4744,q,1
220908,23,5,1,9,10,m,Matt.jpg,pieFS5.bmp,Matt just found $50 on the street,1,resources,430344,436514,6170,q,1
220908,24,5,1,9,10,f,Deborah.jpg,pieFS5.bmp,Deborah illegally parks in the disabled parking spots when she can.,1,reputation,448790,450633,1843,p,0
220908,25,5,1,9,10,f,Joanna.jpg,pieFS5.bmp,Joanna's car with her bag and credit cards was recently stolen.,2,na,462907,464993,2086,q,1
220908,26,5,2,18,20,m,Peter.jpg,pieFS5.bmp,Peter is homeless,2,na,477225,479394,2169,q,1
220908,27,4,1,4,5,f,Maria.jpg,pieFS4.bmp,Maria just found out that her husband has incurred a large credit card debt.,2,na,491641,493534,1893,q,1
220908,28,4,3,12,15,m,Kevin.jpg,pieFS4.bmp,Kevin is saving to pay his university fees,2,na,505759,507414,1655,q,1
220908,29,1,8,8,16,m,Daniel.jpg,pieFS1.bmp,Daniel is a retiree,2,na,519643,522014,2371,q,1
220908,30,3,4,9,13,m,Nick.jpg,pieFS3.bmp,Nick lives in a luxury penthouse apartment,1,resources,534244,538394,4150,q,1
220908,31,3,4,9,13,m,Mark.jpg,pieFS3.bmp,Mark stole money from his mother's wallet.,1,reputation,550625,552714,2089,p,0
220908,32,3,4,9,13,m,Alan.jpg,pieFS3.bmp,Alan just bought an expensive sports car,1,resources,564942,579074,14132,q,1
220908,33,2,6,9,15,m,George.jpg,pieFS2.bmp,George is saving for his son's operation,2,na,591329,593614,2285,q,1
220908,34,3,5,11,16,m,Ben.jpg,pieFS3.bmp,Ben lost his life savings when his small business failed,2,na,605880,608134,2254,q,1
220908,35,4,2,8,10,m,Ian.jpg,pieFS4.bmp,Ian cheated on his taxes and is now under investigation for tax fraud.,1,reputation,620380,622814,2434,p,0
220908,36,4,3,12,15,f,Janet.jpg,pieFS4.bmp,Janet regularly fires employees to avoid promoting them.,1,reputation,635047,636914,1867,p,0
220908,37,5,2,18,20,m,Ricky.jpg,pieFS5.bmp,Ricky bullies his employees to put in extra hours at work.,1,reputation,649148,650854,1706,p,0
220908,38,3,3,7,10,f,Beth.jpg,pieFS3.bmp,Beth secretly gambles with her husband's savings.,1,reputation,663082,664874,1792,p,0
220908,39,5,2,18,20,m,Don.jpg,pieFS5.bmp,Don is a veteran having trouble finding employment.,2,na,677083,678934,1851,q,1
220908,40,5,1,9,10,f,Emily.jpg,pieFS5.bmp,Emily is a highly paid actress,1,resources,691150,698574,7424,p,0
220908,41,4,2,8,10,m,Stuart.jpg,pieFS4.bmp,Stuart stole his elderly father's prescription medications.,1,reputation,710795,712814,2019,p,0
220908,42,1,10,10,20,f,Jean.jpg,pieFS1.bmp,Jean has to take an unpaid leave of absence because her mother broke her hip.,2,na,725046,727934,2888,q,1
220908,43,3,5,11,16,f,Lauren.jpg,pieFS3.bmp,Lauren got a large cash bonus from her boss,1,resources,740162,743714,3552,q,1
220908,44,4,4,16,20,f,Miriam.jpg,pieFS4.bmp,Miriam claims false expenses for her reportable work travel.,1,reputation,755928,757715,1787,p,0
220908,45,5,1,9,10,m,Jared.jpg,pieFS5.bmp,Jared just lost his job,2,na,769945,771875,1930,q,1
220908,46,4,3,12,15,f,Kay.jpg,pieFS4.bmp,Kay works as a cleaner in a hotel,2,na,784096,786175,2079,q,1
220908,47,2,8,12,20,f,Mary.jpg,pieFS2.bmp,Mary's husband is a wealthy investment banker,1,resources,798396,804235,5839,q,1
220908,48,4,1,4,5,m,Justin.jpg,pieFS4.bmp,Justin employs illegal immigrants and pays them less than minimum wage.,1,reputation,816443,818635,2192,p,0
220908,49,5,1,9,10,f,Jenny.jpg,pieFS5.bmp,Jenny was a victim of identity theft and is now thousands of dollars in debt.,2,na,830860,832875,2015,q,1
220908,50,4,2,8,10,f,Eileen.jpg,pieFS4.bmp,Eileen works two waitressing jobs to pay her bills.,2,na,845094,846895,1801,q,1
220908,51,2,7,10,17,f,Emma.jpg,pieFS2.bmp,Emma can't afford to pay her medical bills,2,na,859128,861055,1927,q,1
220908,52,3,6,14,20,m,Tony.jpg,pieFS3.bmp,Tony declared bankruptcy after he was laid off.,2,na,873262,875015,1753,q,1
220909,1,3,4,9,13,m,Paul.jpg,pieFS3.bmp,Paul is hiding his taxable income in Switzerland.,1,reputation,41219,54391,13172,q,1
220909,2,3,2,4,6,f,Cindy.jpg,pieFS3.bmp,Cindy takes discarded food from grocery stores to feed her children.,2,na,66641,73331,6690,q,1
220909,3,4,3,12,15,m,Matt.jpg,pieFS4.bmp,Matt was injured in a hit-and-run accident and cannot afford his medical bills.,2,na,85536,88332,2796,q,1
220909,4,4,4,16,20,f,Marny.jpg,pieFS4.bmp,Marny steals her coworkers' tips to buy alcohol.,1,reputation,100553,104532,3979,p,0
220909,5,4,2,8,10,f,Kelly.jpg,pieFS4.bmp,Kelly just lost her small business after a franchise moved in next door.,2,na,116768,122092,5324,p,0
220909,6,1,8,8,16,m,Stuart.jpg,pieFS1.bmp,Stuart was mugged and had his wallet stolen.,2,na,134316,137613,3297,q,1
220909,7,5,1,9,10,f,Sammy.jpg,pieFS5.bmp,Sammy used her mother's social security number to open a credit card account.,1,reputation,149815,152193,2378,p,0
220909,8,2,7,10,17,f,Eileen.jpg,pieFS2.bmp,Eileen is raising money to buy gifts for children in need.,2,na,164432,166993,2561,q,1
220909,9,5,1,9,10,f,Miriam.jpg,pieFS5.bmp,Miriam owns an international company,1,resources,179216,181674,2458,p,0
220909,10,2,3,4,7,f,Joanna.jpg,pieFS2.bmp,Joanna illegally parks in the disabled parking spots when she can.,1,reputation,193883,196394,2511,q,1
220909,11,4,4,16,20,f,Arianna.jpg,pieFS4.bmp,Arianna received a large inheritance from a distant relative,1,resources,208600,210954,2354,p,0
220909,12,3,4,9,13,m,Sam.jpg,pieFS3.bmp,Sam often goes through and steals the neighbors' mail.,1,reputation,223184,225555,2371,p,0
220909,13,4,1,4,5,m,Tony.jpg,pieFS4.bmp,Tony has been unable to find a job for over a year.,2,na,237784,241155,3371,q,1
220909,14,3,3,7,10,f,Fay.jpg,pieFS3.bmp,Fay is a single mother,2,na,253367,255735,2368,q,1
220909,15,4,1,4,5,m,George.jpg,pieFS4.bmp,George underreports his company's earnings and pockets the profits.,1,reputation,267967,270175,2208,p,0
220909,16,2,8,12,20,f,Fiona.jpg,pieFS2.bmp,Fiona just won the lottery,1,resources,282401,286236,3835,p,0
220909,17,1,9,9,18,m,Joe.jpg,pieFS1.bmp,Joe is a well paid lawyer,1,resources,298450,300076,1626,q,1
220909,18,3,6,14,20,m,Ricky.jpg,pieFS3.bmp,Ricky is a retiree,2,na,312301,314616,2315,p,0
220909,19,4,2,8,10,f,Jenny.jpg,pieFS4.bmp,Jenny's car with her bag and credit cards was recently stolen.,2,na,326819,330456,3637,p,0
220909,20,3,2,4,6,f,Lauren.jpg,pieFS3.bmp,Lauren just found out that her husband has incurred a large credit card debt.,2,na,342684,347877,5193,q,1
220909,21,4,3,12,15,f,Emily.jpg,pieFS4.bmp,Emily is a highly paid actress,1,resources,360082,362197,2115,p,0
220909,22,5,2,18,20,m,Ian.jpg,pieFS5.bmp,Ian lost his house in a fire,2,na,374399,377357,2958,p,0
220909,23,4,2,8,10,m,Jack.jpg,pieFS4.bmp,Jack just found $50 on the street,1,resources,389566,391958,2392,p,0
220909,24,5,1,9,10,f,Sharon.jpg,pieFS5.bmp,Sharon cannot afford to send her son to college.,2,na,404183,406098,1915,p,0
220909,25,4,1,4,5,f,Maria.jpg,pieFS4.bmp,Maria has to take an unpaid leave of absence because her mother broke her hip.,2,na,418300,422618,4318,q,1
220909,26,3,4,9,13,m,Justin.jpg,pieFS3.bmp,Justin just bought an expensive sports car,1,resources,434832,437218,2386,p,0
220909,27,3,2,4,6,f,Emma.jpg,pieFS3.bmp,Emma regularly fires employees to avoid promoting them.,1,reputation,449432,453759,4327,q,1
220909,28,5,2,18,20,f,Beth.jpg,pieFS5.bmp,Beth secretly gambles with her husband's savings.,1,reputation,465964,467979,2015,p,0
220909,29,3,6,14,20,m,Brad.jpg,pieFS3.bmp,Brad is homeless,2,na,480182,509462,29280,q,1
220909,30,5,1,9,10,m,Kevin.jpg,pieFS5.bmp,Kevin is saving to pay his university fees,2,na,521702,524040,2338,p,0
220909,31,4,4,16,20,m,Alan.jpg,pieFS4.bmp,Alan is saving for his son's operation,2,na,536269,538600,2331,p,0
220909,32,3,3,7,10,f,Kay.jpg,pieFS3.bmp,Kay claims false expenses for her reportable work travel.,1,reputation,550820,554441,3621,p,0
220909,33,5,2,18,20,m,Peter.jpg,pieFS5.bmp,Peter lives in a luxury penthouse apartment,1,resources,566652,568701,2049,p,0
220909,34,5,1,9,10,f,Jackie.jpg,pieFS5.bmp,Jackie got a large cash bonus from her boss,1,resources,580920,583001,2081,p,0
220909,35,5,1,9,10,m,Darnell.jpg,pieFS5.bmp,Darnell stole money from his mother's wallet.,1,reputation,595221,597861,2640,p,0
220909,36,3,2,4,6,f,Janet.jpg,pieFS3.bmp,Janet works as a cleaner in a hotel,2,na,610087,611662,1575,q,1
220909,37,4,3,12,15,m,Daniel.jpg,pieFS4.bmp,Daniel bullies his employees to put in extra hours at work.,1,reputation,623872,625482,1610,p,0
220909,38,1,10,10,20,f,Deborah.jpg,pieFS1.bmp,Deborah was a victim of identity theft and is now thousands of dollars in debt.,2,na,637690,640562,2872,q,1
220909,39,5,1,9,10,f,Monica.jpg,pieFS5.bmp,Monica works two waitressing jobs to pay her bills.,2,na,652773,654043,1270,p,0
220909,40,3,5,11,16,f,Louise.jpg,pieFS3.bmp,Louise's husband is a wealthy investment banker,1,resources,666275,667783,1508,p,0
220909,41,1,5,5,10,f,Jean.jpg,pieFS1.bmp,Jean just received a huge cash settlement,1,resources,679993,681323,1330,q,1
220909,42,4,3,12,15,f,Trish.jpg,pieFS4.bmp,Trish can't afford to pay her medical bills,2,na,693545,694764,1219,p,0
220909,43,3,5,11,16,m,Jared.jpg,pieFS3.bmp,Jared just lost his job,2,na,706980,710664,3684,p,0
220909,44,2,6,9,15,m,Edward.jpg,pieFS2.bmp,Edward employs illegal immigrants and pays them less than minimum wage.,1,reputation,722879,735804,12925,p,0
220909,45,2,6,9,15,m,Saul.jpg,pieFS2.bmp,Saul lost his life savings when his small business failed,2,na,748034,757285,9251,q,1
220909,46,2,3,4,7,m,Taymar.jpg,pieFS2.bmp,Taymar could not afford his mortgage and his home was foreclosed.,2,na,769527,771065,1538,q,1
220909,47,5,2,18,20,m,Nick.jpg,pieFS5.bmp,Nick cheated on his taxes and is now under investigation for tax fraud.,1,reputation,783295,784785,1490,p,0
220909,48,5,2,18,20,m,Ben.jpg,pieFS5.bmp,Ben is a veteran having trouble finding employment.,2,na,797013,798845,1832,p,0
220909,49,3,3,7,10,m,Mark.jpg,pieFS3.bmp,Mark stole his elderly father's prescription medications.,1,reputation,811064,819346,8282,p,0
220909,50,5,1,9,10,m,Michael.jpg,pieFS5.bmp,Michael declared bankruptcy after he was laid off.,2,na,831575,834046,2471,p,0
220909,51,5,1,9,10,f,Mary.jpg,pieFS5.bmp,Mary is going to be evicted because she is behind on her rent,2,na,846259,850006,3747,p,0
220909,52,4,2,8,10,m,Don.jpg,pieFS4.bmp,Don takes valuables from his friends' homes when asked to house-sit.,1,reputation,862208,863387,1179,p,0
220913,1,5,2,18,20,m,Jared.jpg,pieFS5.bmp,Jared employs illegal immigrants and pays them less than minimum wage.,1,reputation,65536,67395,1859,p,0
220913,2,3,3,7,10,f,Monica.jpg,pieFS3.bmp,Monica just lost her small business after a franchise moved in next door.,2,na,79637,81856,2219,q,1
220913,3,2,3,4,7,m,Matt.jpg,pieFS2.bmp,Matt was injured in a hit-and-run accident and cannot afford his medical bills.,2,na,94104,95976,1872,q,1
220913,4,5,1,9,10,f,Louise.jpg,pieFS5.bmp,Louise owns an international company,1,resources,108205,109776,1571,p,0
220913,5,5,1,9,10,m,Michael.jpg,pieFS5.bmp,Michael was mugged and had his wallet stolen.,2,na,122007,123576,1569,q,1
220913,6,5,2,18,20,f,Jackie.jpg,pieFS5.bmp,Jackie used her mother's social security number to open a credit card account.,1,reputation,135808,137596,1788,p,0
220913,7,2,8,12,20,f,Trish.jpg,pieFS2.bmp,Trish received a large inheritance from a distant relative,1,resources,149809,152017,2208,q,1
220913,8,3,2,4,6,f,Cindy.jpg,pieFS3.bmp,Cindy is raising money to buy gifts for children in need.,2,na,164226,165537,1311,q,1
220913,9,4,2,8,10,m,Tony.jpg,pieFS4.bmp,Tony often goes through and steals the neighbors' mail.,1,reputation,177761,179277,1516,p,0
220913,10,3,5,11,16,m,Kevin.jpg,pieFS3.bmp,Kevin has been unable to find a job for over a year.,2,na,191496,192997,1501,q,1
220913,11,4,3,12,15,m,George.jpg,pieFS4.bmp,George could not afford his mortgage and his home was foreclosed.,2,na,205214,207198,1984,q,1
220913,12,1,10,10,20,f,Miriam.jpg,pieFS1.bmp,Miriam is a single mother,2,na,219432,221058,1626,q,1
220913,13,4,3,12,15,f,Marny.jpg,pieFS4.bmp,Marny illegally parks in the disabled parking spots when she can.,1,reputation,233350,234958,1608,p,0
220913,14,5,1,9,10,f,Janet.jpg,pieFS5.bmp,Janet just won the lottery,1,resources,247218,250979,3761,q,1
220913,15,4,2,8,10,f,Lauren.jpg,pieFS4.bmp,Lauren's car with her bag and credit cards was recently stolen.,2,na,263233,264859,1626,q,1
220913,16,3,6,14,20,m,Stuart.jpg,pieFS3.bmp,Stuart lost his house in a fire,2,na,277101,278659,1558,q,1
220913,17,5,2,18,20,m,Sam.jpg,pieFS5.bmp,Sam just found $50 on the street,1,resources,290903,293599,2696,q,1
220913,18,4,2,8,10,f,Fiona.jpg,pieFS4.bmp,Fiona cannot afford to send her son to college.,2,na,305836,306680,844,q,1
220913,19,2,7,10,17,f,Jean.jpg,pieFS2.bmp,Jean just found out that her husband has incurred a large credit card debt.,2,na,318905,321640,2735,q,1
220913,20,5,2,18,20,m,Jack.jpg,pieFS5.bmp,Jack is homeless,2,na,333888,335500,1612,q,1
220913,21,4,4,16,20,f,Sammy.jpg,pieFS4.bmp,Sammy is a highly paid actress,1,resources,347723,351800,4077,q,1
220913,22,5,1,9,10,f,Joanna.jpg,pieFS5.bmp,Joanna has to take an unpaid leave of absence because her mother broke her hip.,2,na,364005,365621,1616,q,1
220913,23,3,5,11,16,f,Maria.jpg,pieFS3.bmp,Maria got a large cash bonus from her boss,1,resources,377856,379361,1505,q,1
220913,24,5,1,9,10,f,Kay.jpg,pieFS5.bmp,Kay regularly fires employees to avoid promoting them.,1,reputation,391591,393361,1770,p,0
220913,25,3,2,4,6,f,Emma.jpg,pieFS3.bmp,Emma secretly gambles with her husband's savings.,1,reputation,405592,407061,1469,p,0
220913,26,2,6,9,15,m,Saul.jpg,pieFS2.bmp,Saul is saving to pay his university fees,2,na,419277,420902,1625,q,1
220913,27,3,2,4,6,f,Jenny.jpg,pieFS3.bmp,Jenny was a victim of identity theft and is now thousands of dollars in debt.,2,na,433128,434702,1574,q,1
220913,28,3,3,7,10,f,Mary.jpg,pieFS3.bmp,Mary claims false expenses for her reportable work travel.,1,reputation,446929,449062,2133,p,0
220913,29,2,6,9,15,m,Brad.jpg,pieFS2.bmp,Brad lives in a luxury penthouse apartment,1,resources,461280,463403,2123,p,0
220913,30,4,3,12,15,f,Deborah.jpg,pieFS4.bmp,Deborah works two waitressing jobs to pay her bills.,2,na,475631,477523,1892,q,1
220913,31,4,3,12,15,m,Joe.jpg,pieFS4.bmp,Joe is hiding his taxable income in Switzerland.,1,reputation,489765,491503,1738,p,0
220913,32,3,4,9,13,m,Alan.jpg,pieFS3.bmp,Alan underreports his company's earnings and pockets the profits.,1,reputation,503733,505284,1551,p,0
220913,33,3,4,9,13,m,Justin.jpg,pieFS3.bmp,Justin is a well paid lawyer,1,resources,517518,519564,2046,p,0
220913,34,5,1,9,10,f,Fay.jpg,pieFS5.bmp,Fay works as a cleaner in a hotel,2,na,531785,533844,2059,q,1
220913,35,1,9,9,18,m,Ben.jpg,pieFS1.bmp,Ben stole money from his mother's wallet.,1,reputation,546086,548744,2658,p,0
220913,36,2,3,4,7,f,Sharon.jpg,pieFS2.bmp,Sharon's husband is a wealthy investment banker,1,resources,560969,563024,2055,q,1
220913,37,1,5,5,10,f,Emily.jpg,pieFS1.bmp,Emily just received a huge cash settlement,1,resources,575254,577245,1991,q,1
220913,38,4,1,4,5,f,Arianna.jpg,pieFS4.bmp,Arianna can't afford to pay her medical bills,2,na,589455,590825,1370,q,1
220913,39,5,1,9,10,m,Don.jpg,pieFS5.bmp,Don lost his life savings when his small business failed,2,na,603056,604745,1689,q,1
220913,40,3,4,9,13,m,Ian.jpg,pieFS3.bmp,Ian cheated on his taxes and is now under investigation for tax fraud.,1,reputation,616974,619786,2812,p,0
220913,41,4,4,16,20,m,Daniel.jpg,pieFS4.bmp,Daniel is a retiree,2,na,632041,634386,2345,q,1
220913,42,3,6,14,20,m,Mark.jpg,pieFS3.bmp,Mark is a veteran having trouble finding employment.,2,na,646641,648526,1885,q,1
220913,43,5,1,9,10,f,Beth.jpg,pieFS5.bmp,Beth is going to be evicted because she is behind on her rent,2,na,660759,662386,1627,q,1
220913,44,4,2,8,10,m,Ricky.jpg,pieFS4.bmp,Ricky just bought an expensive sports car,1,resources,674593,677547,2954,p,0
220913,45,5,1,9,10,m,Peter.jpg,pieFS5.bmp,Peter stole his elderly father's prescription medications.,1,reputation,689776,692267,2491,p,0
220913,46,3,2,4,6,f,Kelly.jpg,pieFS3.bmp,Kelly takes discarded food from grocery stores to feed her children.,2,na,704493,706527,2034,q,1
220913,47,4,1,4,5,m,Taymar.jpg,pieFS4.bmp,Taymar is saving for his son's operation,2,na,718761,720367,1606,q,1
220913,48,3,3,7,10,m,Edward.jpg,pieFS3.bmp,Edward bullies his employees to put in extra hours at work.,1,reputation,732579,734528,1949,p,0
220913,49,5,2,18,20,m,Paul.jpg,pieFS5.bmp,Paul just lost his job,2,na,746747,747528,781,q,1
220913,50,4,4,16,20,f,Eileen.jpg,pieFS4.bmp,Eileen steals her coworkers' tips to buy alcohol.,1,reputation,759732,761188,1456,p,0
220913,51,1,8,8,16,m,Darnell.jpg,pieFS1.bmp,Darnell declared bankruptcy after he was laid off.,2,na,773417,774108,691,q,1
220913,52,4,1,4,5,m,Nick.jpg,pieFS4.bmp,Nick takes valuables from his friends' homes when asked to house-sit.,1,reputation,786319,787989,1670,p,0
220926,1,5,1,9,10,f,Fay.jpg,pieFS5.bmp,Fay secretly gambles with her husband's savings.,1,reputation,35306,54790,19484,q,1
220926,2,3,3,7,10,f,Kay.jpg,pieFS3.bmp,Kay claims false expenses for her reportable work travel.,1,reputation,67042,68103,1061,q,1
220926,3,3,2,4,6,f,Joanna.jpg,pieFS3.bmp,Joanna just lost her small business after a franchise moved in next door.,2,na,80301,91026,10725,q,1
220926,4,3,5,11,16,f,Lauren.jpg,pieFS3.bmp,Lauren used her mother's social security number to open a credit card account.,1,reputation,103226,104249,1023,q,1
220926,5,4,2,8,10,f,Janet.jpg,pieFS4.bmp,Janet works as a cleaner in a hotel,2,na,116435,118231,1796,q,1
220926,6,1,5,5,10,f,Louise.jpg,pieFS1.bmp,Louise's husband is a wealthy investment banker,1,resources,130430,132579,2149,q,1
220926,7,1,8,8,16,m,Kevin.jpg,pieFS1.bmp,Kevin is homeless,2,na,144777,146576,1799,q,1
220926,8,4,3,12,15,m,Michael.jpg,pieFS4.bmp,Michael is saving to pay his university fees,2,na,158772,160686,1914,q,1
220926,9,4,1,4,5,m,Ricky.jpg,pieFS4.bmp,Ricky is a well paid lawyer,1,resources,172901,174936,2035,q,1
220926,10,2,6,9,15,m,Edward.jpg,pieFS2.bmp,Edward is a retiree,2,na,187131,188969,1838,q,1
220926,11,5,2,18,20,m,Mark.jpg,pieFS5.bmp,Mark lives in a luxury penthouse apartment,1,resources,201176,203454,2278,q,1
220926,12,1,10,10,20,f,Kelly.jpg,pieFS1.bmp,Kelly is raising money to buy gifts for children in need.,2,na,215640,217095,1455,q,1
220926,13,3,3,7,10,m,Sam.jpg,pieFS3.bmp,Sam stole money from his mother's wallet.,1,reputation,229284,236440,7156,p,0
220926,14,3,5,11,16,m,Ian.jpg,pieFS3.bmp,Ian lost his life savings when his small business failed,2,na,248630,251331,2701,q,1
220926,15,5,2,18,20,f,Jenny.jpg,pieFS5.bmp,Jenny illegally parks in the disabled parking spots when she can.,1,reputation,263528,266238,2710,p,0
220926,16,5,1,9,10,m,Joe.jpg,pieFS5.bmp,Joe just bought an expensive sports car,1,resources,278427,279701,1274,q,1
220926,17,4,3,12,15,f,Cindy.jpg,pieFS4.bmp,Cindy's car with her bag and credit cards was recently stolen.,2,na,291920,292660,740,q,1
220926,18,5,1,9,10,f,Maria.jpg,pieFS5.bmp,Maria just found out that her husband has incurred a large credit card debt.,2,na,304845,306140,1295,q,1
220926,19,5,1,9,10,f,Emily.jpg,pieFS5.bmp,Emily is a highly paid actress,1,resources,318306,319406,1100,q,1
220926,20,3,4,9,13,m,Darnell.jpg,pieFS3.bmp,Darnell cheated on his taxes and is now under investigation for tax fraud.,1,reputation,331582,335250,3668,q,1
220926,21,5,1,9,10,m,Peter.jpg,pieFS5.bmp,Peter is a veteran having trouble finding employment.,2,na,347433,349471,2038,q,1
220926,22,4,3,12,15,m,Matt.jpg,pieFS4.bmp,Matt stole his elderly father's prescription medications.,1,reputation,361646,367158,5512,p,0
220926,23,5,1,9,10,f,Jean.jpg,pieFS5.bmp,Jean has to take an unpaid leave of absence because her mother broke her hip.,2,na,379370,382096,2726,q,1
220926,24,4,4,16,20,m,Jack.jpg,pieFS4.bmp,Jack declared bankruptcy after he was laid off.,2,na,394285,395003,718,q,1
220926,25,3,6,14,20,m,Taymar.jpg,pieFS3.bmp,Taymar is saving for his son's operation,2,na,407210,408231,1021,q,1
220926,26,4,3,12,15,f,Sammy.jpg,pieFS4.bmp,Sammy got a large cash bonus from her boss,1,resources,420420,422614,2194,q,1
220926,27,3,3,7,10,f,Deborah.jpg,pieFS3.bmp,Deborah was a victim of identity theft and is now thousands of dollars in debt.,2,na,434783,436146,1363,q,1
220926,28,4,1,4,5,f,Monica.jpg,pieFS4.bmp,Monica works two waitressing jobs to pay her bills.,2,na,448327,450146,1819,q,1
220926,29,5,1,9,10,f,Fiona.jpg,pieFS5.bmp,Fiona can't afford to pay her medical bills,2,na,462322,463578,1256,q,1
220926,30,2,7,10,17,f,Arianna.jpg,pieFS2.bmp,Arianna is going to be evicted because she is behind on her rent,2,na,475766,478085,2319,q,1
220926,31,1,9,9,18,m,Brad.jpg,pieFS1.bmp,Brad takes valuables from his friends' homes when asked to house-sit.,1,reputation,490279,505727,15448,q,1
220926,32,4,2,8,10,m,George.jpg,pieFS4.bmp,George bullies his employees to put in extra hours at work.,1,reputation,517919,520587,2668,q,1
220926,33,5,2,18,20,m,Paul.jpg,pieFS5.bmp,Paul just lost his job,2,na,532784,534947,2163,q,1
220926,34,4,4,16,20,f,Sharon.jpg,pieFS4.bmp,Sharon owns an international company,1,resources,547147,549057,1910,q,1
220926,35,2,8,12,20,f,Miriam.jpg,pieFS2.bmp,Miriam received a large inheritance from a distant relative,1,resources,561259,562924,1665,q,1
220926,36,4,1,4,5,m,Stuart.jpg,pieFS4.bmp,Stuart was injured in a hit-and-run accident and cannot afford his medical bills.,2,na,575121,576471,1350,q,1
220926,37,5,1,9,10,m,Tony.jpg,pieFS5.bmp,Tony was mugged and had his wallet stolen.,2,na,588665,590642,1977,q,1
220926,38,3,2,4,6,f,Emma.jpg,pieFS3.bmp,Emma is a single mother,2,na,602844,604473,1629,q,1
220926,39,5,2,18,20,m,Saul.jpg,pieFS5.bmp,Saul often goes through and steals the neighbors' mail.,1,reputation,616672,619676,3004,p,0
220926,40,2,3,4,7,m,Ben.jpg,pieFS2.bmp,Ben has been unable to find a job for over a year.,2,na,631871,632896,1025,q,1
220926,41,5,1,9,10,f,Trish.jpg,pieFS5.bmp,Trish just won the lottery,1,resources,645081,647190,2109,q,1
220926,42,3,4,9,13,m,Jared.jpg,pieFS3.bmp,Jared employs illegal immigrants and pays them less than minimum wage.,1,reputation,659360,661038,1678,q,1
220926,43,3,2,4,6,f,Jackie.jpg,pieFS3.bmp,Jackie just received a huge cash settlement,1,resources,673222,674898,1676,q,1
220926,44,3,6,14,20,m,Justin.jpg,pieFS3.bmp,Justin could not afford his mortgage and his home was foreclosed.,2,na,687100,689179,2079,q,1
220926,45,4,2,8,10,m,Daniel.jpg,pieFS4.bmp,Daniel is hiding his taxable income in Switzerland.,1,reputation,701363,702716,1353,q,1
220926,46,4,2,8,10,f,Marny.jpg,pieFS4.bmp,Marny takes discarded food from grocery stores to feed her children.,2,na,714907,716374,1467,q,1
220926,47,5,2,18,20,m,Don.jpg,pieFS5.bmp,Don lost his house in a fire,2,na,728551,730202,1651,q,1
220926,48,4,4,16,20,f,Eileen.jpg,pieFS4.bmp,Eileen steals her coworkers' tips to buy alcohol.,1,reputation,742379,743859,1480,q,1
220926,49,3,2,4,6,f,Beth.jpg,pieFS3.bmp,Beth cannot afford to send her son to college.,2,na,756057,757485,1428,q,1
220926,50,2,3,4,7,f,Mary.jpg,pieFS2.bmp,Mary regularly fires employees to avoid promoting them.,1,reputation,769685,770879,1194,q,1
220926,51,3,4,9,13,m,Nick.jpg,pieFS3.bmp,Nick just found $50 on the street,1,resources,783078,785236,2158,q,1
220926,52,2,6,9,15,m,Alan.jpg,pieFS2.bmp,Alan underreports his company's earnings and pockets the profits.,1,reputation,797408,799409,2001,q,1
220927,1,3,3,7,10,f,Emma.jpg,pieFS3.bmp,Emma secretly gambles with her husband's savings.,1,reputation,168298,177609,9311,p,0
220927,2,3,4,9,13,m,Ben.jpg,pieFS3.bmp,Ben often goes through and steals the neighbors' mail.,1,reputation,189807,194449,4642,p,0
220927,3,3,4,9,13,m,Alan.jpg,pieFS3.bmp,Alan employs illegal immigrants and pays them less than minimum wage.,1,reputation,206622,209889,3267,p,0
220927,4,3,5,11,16,m,Don.jpg,pieFS3.bmp,Don has been unable to find a job for over a year.,2,na,222088,225049,2961,q,1
220927,5,4,1,4,5,m,Paul.jpg,pieFS4.bmp,Paul could not afford his mortgage and his home was foreclosed.,2,na,237237,241529,4292,p,0
220927,6,1,9,9,18,m,Ricky.jpg,pieFS1.bmp,Ricky is hiding his taxable income in Switzerland.,1,reputation,253702,256510,2808,q,1
220927,7,2,3,4,7,m,Tony.jpg,pieFS2.bmp,Tony lost his house in a fire,2,na,268669,271410,2741,q,1
220927,8,5,1,9,10,m,Jack.jpg,pieFS5.bmp,Jack just found $50 on the street,1,resources,283569,287990,4421,p,0
220927,9,4,2,8,10,f,Monica.jpg,pieFS4.bmp,Monica is raising money to buy gifts for children in need.,2,na,300167,303190,3023,q,1
220927,10,5,1,9,10,f,Jenny.jpg,pieFS5.bmp,Jenny illegally parks in the disabled parking spots when she can.,1,reputation,315350,318890,3540,p,0
220927,11,1,8,8,16,m,Sam.jpg,pieFS1.bmp,Sam is homeless,2,na,331049,333750,2701,p,0
220927,12,4,3,12,15,f,Louise.jpg,pieFS4.bmp,Louise claims false expenses for her reportable work travel.,1,reputation,345915,352950,7035,p,0
220927,13,4,4,16,20,m,Stuart.jpg,pieFS4.bmp,Stuart is saving to pay his university fees,2,na,365144,368750,3606,q,1
220927,14,4,3,12,15,m,Nick.jpg,pieFS4.bmp,Nick lives in a luxury penthouse apartment,1,resources,380943,382870,1927,p,0
220927,15,3,2,4,6,f,Trish.jpg,pieFS3.bmp,Trish works as a cleaner in a hotel,2,na,395060,398090,3030,q,1
220927,16,4,2,8,10,m,Joe.jpg,pieFS4.bmp,Joe underreports his company's earnings and pockets the profits.,1,reputation,410276,412790,2514,p,0
220927,17,5,1,9,10,f,Fay.jpg,pieFS5.bmp,Fay's husband is a wealthy investment banker,1,resources,424943,428270,3327,p,0
220927,18,5,2,18,20,m,Justin.jpg,pieFS5.bmp,Justin is a well paid lawyer,1,resources,440426,442970,2544,p,0
220927,19,4,2,8,10,m,Saul.jpg,pieFS4.bmp,Saul stole money from his mother's wallet.,1,reputation,455142,457710,2568,p,0
220927,20,4,3,12,15,m,Darnell.jpg,pieFS4.bmp,Darnell lost his life savings when his small business failed,2,na,469876,472890,3014,p,0
220927,21,2,7,10,17,f,Marny.jpg,pieFS2.bmp,Marny's car with her bag and credit cards was recently stolen.,2,na,485059,488090,3031,q,1
220927,22,4,3,12,15,f,Eileen.jpg,pieFS4.bmp,Eileen just found out that her husband has incurred a large credit card debt.,2,na,500258,502830,2572,p,0
220927,23,3,2,4,6,f,Jean.jpg,pieFS3.bmp,Jean is a highly paid actress,1,resources,515025,517530,2505,q,1
220927,24,4,1,4,5,f,Beth.jpg,pieFS4.bmp,Beth can't afford to pay her medical bills,2,na,529725,534011,4286,q,1
220927,25,5,1,9,10,f,Emily.jpg,pieFS5.bmp,Emily has to take an unpaid leave of absence because her mother broke her hip.,2,na,546207,550271,4064,q,1
220927,26,5,1,9,10,f,Janet.jpg,pieFS5.bmp,Janet is going to be evicted because she is behind on her rent,2,na,562438,565131,2693,p,0
220927,27,4,4,16,20,f,Lauren.jpg,pieFS4.bmp,Lauren got a large cash bonus from her boss,1,resources,577305,580071,2766,p,0
220927,28,5,2,18,20,f,Arianna.jpg,pieFS5.bmp,Arianna owns an international company,1,resources,592238,594551,2313,p,0
220927,29,3,4,9,13,m,Kevin.jpg,pieFS3.bmp,Kevin cheated on his taxes and is now under investigation for tax fraud.,1,reputation,606722,610611,3889,q,1
220927,30,3,6,14,20,m,Daniel.jpg,pieFS3.bmp,Daniel is a retiree,2,na,622771,625171,2400,q,1
220927,31,3,3,7,10,f,Joanna.jpg,pieFS3.bmp,Joanna was a victim of identity theft and is now thousands of dollars in debt.,2,na,637338,640751,3413,q,1
220927,32,2,3,4,7,f,Kay.jpg,pieFS2.bmp,Kay received a large inheritance from a distant relative,1,resources,652937,655671,2734,q,1
220927,33,3,6,14,20,m,Ian.jpg,pieFS3.bmp,Ian is a veteran having trouble finding employment.,2,na,667870,670511,2641,q,1
220927,34,4,2,8,10,f,Sammy.jpg,pieFS4.bmp,Sammy works two waitressing jobs to pay her bills.,2,na,682703,686191,3488,q,1
220927,35,2,8,12,20,f,Deborah.jpg,pieFS2.bmp,Deborah just received a huge cash settlement,1,resources,698386,701031,2645,q,1
220927,36,3,3,7,10,m,George.jpg,pieFS3.bmp,George just bought an expensive sports car,1,resources,713186,716711,3525,q,1
220927,37,1,10,10,20,f,Sharon.jpg,pieFS1.bmp,Sharon is a single mother,2,na,728868,731471,2603,q,1
220927,38,5,2,18,20,m,Mark.jpg,pieFS5.bmp,Mark stole his elderly father's prescription medications.,1,reputation,743618,746891,3273,p,0
220927,39,2,6,9,15,m,Taymar.jpg,pieFS2.bmp,Taymar is saving for his son's operation,2,na,759051,765171,6120,q,1
220927,40,4,4,16,20,f,Miriam.jpg,pieFS4.bmp,Miriam just won the lottery,1,resources,777330,781952,4622,p,0
220927,41,3,2,4,6,f,Mary.jpg,pieFS3.bmp,Mary cannot afford to send her son to college.,2,na,794111,796412,2301,q,1
220927,42,1,5,5,10,f,Fiona.jpg,pieFS1.bmp,Fiona regularly fires employees to avoid promoting them.,1,reputation,808645,812812,4167,p,0
220927,43,5,1,9,10,f,Kelly.jpg,pieFS5.bmp,Kelly takes discarded food from grocery stores to feed her children.,2,na,825043,827492,2449,p,0
220927,44,4,1,4,5,m,Jared.jpg,pieFS4.bmp,Jared bullies his employees to put in extra hours at work.,1,reputation,839727,841872,2145,p,0
220927,45,5,1,9,10,m,Matt.jpg,pieFS5.bmp,Matt declared bankruptcy after he was laid off.,2,na,854094,856552,2458,p,0
220927,46,2,6,9,15,m,Peter.jpg,pieFS2.bmp,Peter takes valuables from his friends' homes when asked to house-sit.,1,reputation,868777,871692,2915,p,0
220927,47,3,5,11,16,f,Jackie.jpg,pieFS3.bmp,Jackie steals her coworkers' tips to buy alcohol.,1,reputation,883927,887012,3085,p,0
220927,48,5,2,18,20,m,Michael.jpg,pieFS5.bmp,Michael was injured in a hit-and-run accident and cannot afford his medical bills.,2,na,899243,902652,3409,q,1
220927,49,5,1,9,10,m,Edward.jpg,pieFS5.bmp,Edward just lost his job,2,na,914876,918712,3836,q,1
220927,50,3,2,4,6,f,Maria.jpg,pieFS3.bmp,Maria just lost her small business after a franchise moved in next door.,2,na,930941,935572,4631,q,1
220927,51,5,1,9,10,f,Cindy.jpg,pieFS5.bmp,Cindy used her mother's social security number to open a credit card account.,1,reputation,947805,951032,3227,p,0
220927,52,5,2,18,20,m,Brad.jpg,pieFS5.bmp,Brad was mugged and had his wallet stolen.,2,na,963238,968232,4994,q,1
220947,1,5,1,9,10,f,Marny.jpg,pieFS5.bmp,Marny got a large cash bonus from her boss,1,resources,44739,49180,4441,p,0
220947,2,5,2,18,20,m,Justin.jpg,pieFS5.bmp,Justin employs illegal immigrants and pays them less than minimum wage.,1,reputation,61377,62980,1603,p,0
220947,3,3,3,7,10,f,Arianna.jpg,pieFS3.bmp,Arianna is a single mother,2,na,75171,78368,3197,q,1
220947,4,3,2,4,6,f,Sammy.jpg,pieFS3.bmp,Sammy was a victim of identity theft and is now thousands of dollars in debt.,2,na,90555,92116,1561,q,1
220947,5,1,5,5,10,f,Beth.jpg,pieFS1.bmp,Beth just won the lottery,1,resources,104316,106028,1712,q,1
220947,6,5,2,18,20,m,Alan.jpg,pieFS5.bmp,Alan could not afford his mortgage and his home was foreclosed.,2,na,118211,119978,1767,q,1
220947,7,4,3,12,15,m,Daniel.jpg,pieFS4.bmp,Daniel is hiding his taxable income in Switzerland.,1,reputation,132190,133852,1662,p,0
220947,8,4,1,4,5,m,Ricky.jpg,pieFS4.bmp,Ricky underreports his company's earnings and pockets the profits.,1,reputation,146068,148252,2184,p,0
220947,9,2,3,4,7,m,Jack.jpg,pieFS2.bmp,Jack is homeless,2,na,160448,162145,1697,q,1
220947,10,5,2,18,20,m,Nick.jpg,pieFS5.bmp,Nick is saving to pay his university fees,2,na,174360,175382,1022,q,1
220947,11,4,3,12,15,f,Jackie.jpg,pieFS4.bmp,Jackie works two waitressing jobs to pay her bills.,2,na,187569,188638,1069,q,1
220947,12,5,2,18,20,m,Jared.jpg,pieFS5.bmp,Jared is a well paid lawyer,1,resources,200846,204724,3878,p,0
220947,13,2,3,4,7,f,Joanna.jpg,pieFS2.bmp,Joanna just received a huge cash settlement,1,resources,216914,218674,1760,q,1
220947,14,5,1,9,10,m,Sam.jpg,pieFS5.bmp,Sam lives in a luxury penthouse apartment,1,resources,230843,233805,2962,p,0
220947,15,5,1,9,10,f,Louise.jpg,pieFS5.bmp,Louise cannot afford to send her son to college.,2,na,245992,248336,2344,p,0
220947,16,3,3,7,10,m,Kevin.jpg,pieFS3.bmp,Kevin stole money from his mother's wallet.,1,reputation,260506,262374,1868,p,0
220947,17,5,1,9,10,f,Deborah.jpg,pieFS5.bmp,Deborah takes discarded food from grocery stores to feed her children.,2,na,274568,276422,1854,q,1
220947,18,5,1,9,10,m,Don.jpg,pieFS5.bmp,Don lost his life savings when his small business failed,2,na,288613,292097,3484,p,0
220947,19,4,4,16,20,f,Fay.jpg,pieFS4.bmp,Fay regularly fires employees to avoid promoting them.,1,reputation,304298,305765,1467,p,0
220947,20,4,2,8,10,m,Michael.jpg,pieFS4.bmp,Michael cheated on his taxes and is now under investigation for tax fraud.,1,reputation,317942,319897,1955,p,0
220947,21,4,3,12,15,m,Paul.jpg,pieFS4.bmp,Paul is a retiree,2,na,332088,334901,2813,p,0
220947,22,3,2,4,6,f,Jean.jpg,pieFS3.bmp,Jean steals her coworkers' tips to buy alcohol.,1,reputation,347103,349000,1897,p,0
220947,23,1,9,9,18,m,George.jpg,pieFS1.bmp,George just bought an expensive sports car,1,resources,361199,363325,2126,q,1
220947,24,1,8,8,16,m,Saul.jpg,pieFS1.bmp,Saul is a veteran having trouble finding employment.,2,na,375512,377232,1720,q,1
220947,25,4,2,8,10,f,Lauren.jpg,pieFS4.bmp,Lauren just lost her small business after a franchise moved in next door.,2,na,389440,392236,2796,p,0
220947,26,3,4,9,13,m,Ian.jpg,pieFS3.bmp,Ian stole his elderly father's prescription medications.,1,reputation,404422,406505,2083,p,0
220947,27,3,6,14,20,m,Joe.jpg,pieFS3.bmp,Joe is saving for his son's operation,2,na,418702,420829,2127,q,1
220947,28,5,1,9,10,f,Jenny.jpg,pieFS5.bmp,Jenny used her mother's social security number to open a credit card account.,1,reputation,433032,435002,1970,p,0
220947,29,5,2,18,20,f,Mary.jpg,pieFS5.bmp,Mary secretly gambles with her husband's savings.,1,reputation,447194,449271,2077,p,0
220947,30,3,5,11,16,f,Trish.jpg,pieFS3.bmp,Trish claims false expenses for her reportable work travel.,1,reputation,461474,463746,2272,p,0
220947,31,4,4,16,20,m,Matt.jpg,pieFS4.bmp,Matt declared bankruptcy after he was laid off.,2,na,475938,478315,2377,p,0
220947,32,4,1,4,5,f,Eileen.jpg,pieFS4.bmp,Eileen is raising money to buy gifts for children in need.,2,na,490518,493483,2965,q,1
220947,33,3,4,9,13,m,Edward.jpg,pieFS3.bmp,Edward bullies his employees to put in extra hours at work.,1,reputation,505701,507601,1900,p,0
220947,34,1,10,10,20,f,Kay.jpg,pieFS1.bmp,Kay works as a cleaner in a hotel,2,na,519796,521550,1754,q,1
220947,35,4,2,8,10,m,Stuart.jpg,pieFS4.bmp,Stuart takes valuables from his friends' homes when asked to house-sit.,1,reputation,533742,535500,1758,p,0
220947,36,2,8,12,20,f,Kelly.jpg,pieFS2.bmp,Kelly illegally parks in the disabled parking spots when she can.,1,reputation,547687,549956,2269,q,1
220947,37,5,1,9,10,m,Ben.jpg,pieFS5.bmp,Ben was injured in a hit-and-run accident and cannot afford his medical bills.,2,na,562150,564467,2317,p,0
220947,38,5,1,9,10,f,Fiona.jpg,pieFS5.bmp,Fiona's husband is a wealthy investment banker,1,resources,576664,578680,2016,p,0
220947,39,3,6,14,20,m,Peter.jpg,pieFS3.bmp,Peter was mugged and had his wallet stolen.,2,na,590877,593322,2445,q,1
220947,40,2,7,10,17,f,Janet.jpg,pieFS2.bmp,Janet can't afford to pay her medical bills,2,na,605524,607779,2255,q,1
220947,41,5,1,9,10,f,Miriam.jpg,pieFS5.bmp,Miriam is going to be evicted because she is behind on her rent,2,na,619971,623786,3815,p,0
220947,42,2,6,9,15,m,Taymar.jpg,pieFS2.bmp,Taymar just lost his job,2,na,635990,637965,1975,q,1
220947,43,3,4,9,13,m,Darnell.jpg,pieFS3.bmp,Darnell often goes through and steals the neighbors' mail.,1,reputation,650169,658608,8439,p,0
220947,44,3,3,7,10,f,Emma.jpg,pieFS3.bmp,Emma owns an international company,1,resources,670803,673982,3179,q,1
220947,45,4,1,4,5,m,Brad.jpg,pieFS4.bmp,Brad has been unable to find a job for over a year.,2,na,686186,688925,2739,q,1
220947,46,3,2,4,6,f,Cindy.jpg,pieFS3.bmp,Cindy's car with her bag and credit cards was recently stolen.,2,na,701118,702912,1794,q,1
220947,47,4,2,8,10,f,Emily.jpg,pieFS4.bmp,Emily just found out that her husband has incurred a large credit card debt.,2,na,715113,717200,2087,p,0
220947,48,3,5,11,16,m,Mark.jpg,pieFS3.bmp,Mark lost his house in a fire,2,na,729376,732049,2673,q,1
220947,49,2,6,9,15,m,Tony.jpg,pieFS2.bmp,Tony just found $50 on the street,1,resources,744224,746767,2543,q,1
220947,50,4,3,12,15,f,Monica.jpg,pieFS4.bmp,Monica is a highly paid actress,1,resources,758955,761035,2080,p,0
220947,51,3,2,4,6,f,Maria.jpg,pieFS3.bmp,Maria has to take an unpaid leave of absence because her mother broke her hip.,2,na,773235,775059,1824,q,1
220947,52,4,4,16,20,f,Sharon.jpg,pieFS4.bmp,Sharon received a large inheritance from a distant relative,1,resources,787230,789497,2267,p,0
220963,1,3,4,9,13,m,George.jpg,pieFS3.bmp,George just bought an expensive sports car,1,resources,121255,134061,12806,q,1
220963,2,3,5,11,16,m,Ian.jpg,pieFS3.bmp,Ian is homeless,2,na,146253,152968,6715,p,0
220963,3,3,6,14,20,m,Matt.jpg,pieFS3.bmp,Matt is saving to pay his university fees,2,na,165181,167234,2053,q,1
220963,4,4,2,8,10,m,Michael.jpg,pieFS4.bmp,Michael lives in a luxury penthouse apartment,1,resources,179427,183501,4074,p,0
220963,5,4,4,16,20,m,Joe.jpg,pieFS4.bmp,Joe is saving for his son's operation,2,na,195696,198955,3259,p,0
220963,6,5,1,9,10,m,Stuart.jpg,pieFS5.bmp,Stuart stole money from his mother's wallet.,1,reputation,211146,215034,3888,p,0
220963,7,1,10,10,20,f,Sammy.jpg,pieFS1.bmp,Sammy works two waitressing jobs to pay her bills.,2,na,227265,229745,2480,p,0
220963,8,2,3,4,7,m,Saul.jpg,pieFS2.bmp,Saul lost his life savings when his small business failed,2,na,241963,244848,2885,q,1
220963,9,5,2,18,20,f,Trish.jpg,pieFS5.bmp,Trish secretly gambles with her husband's savings.,1,reputation,257062,259474,2412,p,0
220963,10,5,2,18,20,m,Don.jpg,pieFS5.bmp,Don cheated on his taxes and is now under investigation for tax fraud.,1,reputation,271693,273959,2266,p,0
220963,11,5,1,9,10,f,Miriam.jpg,pieFS5.bmp,Miriam claims false expenses for her reportable work travel.,1,reputation,286173,288430,2257,p,0
220963,12,3,2,4,6,f,Janet.jpg,pieFS3.bmp,Janet works as a cleaner in a hotel,2,na,300620,302960,2340,q,1
220963,13,1,5,5,10,f,Jenny.jpg,pieFS1.bmp,Jenny just received a huge cash settlement,1,resources,315167,318071,2904,q,1
220963,14,4,2,8,10,f,Emily.jpg,pieFS4.bmp,Emily takes discarded food from grocery stores to feed her children.,2,na,330283,333087,2804,p,0
220963,15,5,1,9,10,f,Mary.jpg,pieFS5.bmp,Mary's husband is a wealthy investment banker,1,resources,345298,347115,1817,p,0
220963,16,3,3,7,10,f,Kelly.jpg,pieFS3.bmp,Kelly steals her coworkers' tips to buy alcohol.,1,reputation,359327,362042,2715,q,1
220963,17,2,6,9,15,m,Jared.jpg,pieFS2.bmp,Jared bullies his employees to put in extra hours at work.,1,reputation,374242,377231,2989,q,1
220963,18,4,3,12,15,m,Peter.jpg,pieFS4.bmp,Peter is a veteran having trouble finding employment.,2,na,389441,392153,2712,p,0
220963,19,1,8,8,16,m,Edward.jpg,pieFS1.bmp,Edward just lost his job,2,na,404373,407376,3003,q,1
220963,20,3,4,9,13,m,Brad.jpg,pieFS3.bmp,Brad stole his elderly father's prescription medications.,1,reputation,419589,422389,2800,q,1
220963,21,3,3,7,10,f,Cindy.jpg,pieFS3.bmp,Cindy just lost her small business after a franchise moved in next door.,2,na,434587,443655,9068,q,1
220963,22,5,1,9,10,m,Tony.jpg,pieFS5.bmp,Tony declared bankruptcy after he was laid off.,2,na,455873,457625,1752,p,0
220963,23,4,1,4,5,f,Kay.jpg,pieFS4.bmp,Kay can't afford to pay her medical bills,2,na,469835,472219,2384,p,0
220963,24,4,3,12,15,m,Ben.jpg,pieFS4.bmp,Ben takes valuables from his friends' homes when asked to house-sit.,1,reputation,484416,487298,2882,q,1
220963,25,3,5,11,16,f,Jackie.jpg,pieFS3.bmp,Jackie used her mother's social security number to open a credit card account.,1,reputation,499515,502189,2674,q,1
220963,26,5,1,9,10,f,Joanna.jpg,pieFS5.bmp,Joanna is raising money to buy gifts for children in need.,2,na,514379,516347,1968,p,0
220963,27,4,2,8,10,m,Alan.jpg,pieFS4.bmp,Alan employs illegal immigrants and pays them less than minimum wage.,1,reputation,528559,530521,1962,p,0
220963,28,5,1,9,10,m,Sam.jpg,pieFS5.bmp,Sam was injured in a hit-and-run accident and cannot afford his medical bills.,2,na,542721,545145,2424,p,0
220963,29,4,1,4,5,m,Ricky.jpg,pieFS4.bmp,Ricky could not afford his mortgage and his home was foreclosed.,2,na,557352,559708,2356,p,0
220963,30,3,2,4,6,f,Eileen.jpg,pieFS3.bmp,Eileen illegally parks in the disabled parking spots when she can.,1,reputation,571916,574115,2199,q,1
220963,31,5,1,9,10,f,Fiona.jpg,pieFS5.bmp,Fiona is going to be evicted because she is behind on her rent,2,na,586313,588700,2387,p,0
220963,32,3,6,14,20,m,Darnell.jpg,pieFS3.bmp,Darnell was mugged and had his wallet stolen.,2,na,600910,603523,2613,q,1
220963,33,1,9,9,18,m,Justin.jpg,pieFS1.bmp,Justin is hiding his taxable income in Switzerland.,1,reputation,615725,618805,3080,q,1
220963,34,5,1,9,10,f,Deborah.jpg,pieFS5.bmp,Deborah's car with her bag and credit cards was recently stolen.,2,na,630991,633040,2049,p,0
220963,35,4,2,8,10,f,Jean.jpg,pieFS4.bmp,Jean just found out that her husband has incurred a large credit card debt.,2,na,645254,648267,3013,p,0
220963,36,2,8,12,20,f,Monica.jpg,pieFS2.bmp,Monica is a highly paid actress,1,resources,660470,662776,2306,q,1
220963,37,2,3,4,7,f,Arianna.jpg,pieFS2.bmp,Arianna owns an international company,1,resources,674983,677824,2841,q,1
220963,38,3,2,4,6,f,Maria.jpg,pieFS3.bmp,Maria has to take an unpaid leave of absence because her mother broke her hip.,2,na,690015,692527,2512,q,1
220963,39,4,1,4,5,m,Jack.jpg,pieFS4.bmp,Jack often goes through and steals the neighbors' mail.,1,reputation,704747,706765,2018,p,0
220963,40,5,2,18,20,m,Nick.jpg,pieFS5.bmp,Nick has been unable to find a job for over a year.,2,na,718976,721326,2350,p,0
220963,41,4,3,12,15,f,Beth.jpg,pieFS4.bmp,Beth received a large inheritance from a distant relative,1,resources,733540,736124,2584,p,0
220963,42,3,4,9,13,m,Paul.jpg,pieFS3.bmp,Paul underreports his company's earnings and pockets the profits.,1,reputation,748338,750937,2599,q,1
220963,43,3,2,4,6,f,Emma.jpg,pieFS3.bmp,Emma is a single mother,2,na,763136,765862,2726,q,1
220963,44,4,4,16,20,f,Sharon.jpg,pieFS4.bmp,Sharon just won the lottery,1,resources,778051,781626,3575,p,0
220963,45,4,3,12,15,f,Louise.jpg,pieFS4.bmp,Louise cannot afford to send her son to college.,2,na,793835,796158,2323,p,0
220963,46,5,2,18,20,m,Taymar.jpg,pieFS5.bmp,Taymar is a well paid lawyer,1,resources,808366,810596,2230,p,0
220963,47,5,2,18,20,m,Mark.jpg,pieFS5.bmp,Mark lost his house in a fire,2,na,822796,824829,2033,p,0
220963,48,5,1,9,10,f,Lauren.jpg,pieFS5.bmp,Lauren got a large cash bonus from her boss,1,resources,837026,839300,2274,p,0
220963,49,3,3,7,10,m,Kevin.jpg,pieFS3.bmp,Kevin just found $50 on the street,1,resources,851522,855317,3795,q,1
220963,50,4,4,16,20,f,Fay.jpg,pieFS4.bmp,Fay regularly fires employees to avoid promoting them.,1,reputation,867524,869865,2341,p,0
220963,51,2,6,9,15,m,Daniel.jpg,pieFS2.bmp,Daniel is a retiree,2,na,882072,884471,2399,q,1
220963,52,2,7,10,17,f,Marny.jpg,pieFS2.bmp,Marny was a victim of identity theft and is now thousands of dollars in debt.,2,na,896686,898928,2242,q,1
220976,1,5,1,9,10,f,Janet.jpg,pieFS5.bmp,Janet claims false expenses for her reportable work travel.,1,reputation,34476,38020,3544,p,0
220976,2,4,3,12,15,f,Jenny.jpg,pieFS4.bmp,Jenny was a victim of identity theft and is now thousands of dollars in debt.,2,na,50291,55520,5229,q,1
220976,3,3,2,4,6,f,Kelly.jpg,pieFS3.bmp,Kelly works two waitressing jobs to pay her bills.,2,na,67771,69420,1649,q,1
220976,4,3,6,14,20,m,Joe.jpg,pieFS3.bmp,Joe just lost his job,2,na,81673,83220,1547,q,1
220976,5,3,2,4,6,f,Joanna.jpg,pieFS3.bmp,Joanna just received a huge cash settlement,1,resources,95474,100540,5066,q,1
220976,6,3,5,11,16,m,Nick.jpg,pieFS3.bmp,Nick has been unable to find a job for over a year.,2,na,112771,114140,1369,q,1
220976,7,4,1,4,5,f,Sharon.jpg,pieFS4.bmp,Sharon works as a cleaner in a hotel,2,na,126356,129520,3164,q,1
220976,8,5,2,18,20,m,Alan.jpg,pieFS5.bmp,Alan employs illegal immigrants and pays them less than minimum wage.,1,reputation,141755,144020,2265,p,0
220976,9,4,3,12,15,m,Ian.jpg,pieFS4.bmp,Ian lost his house in a fire,2,na,156239,157540,1301,q,1
220976,10,5,1,9,10,f,Fiona.jpg,pieFS5.bmp,Fiona's husband is a wealthy investment banker,1,resources,169773,172841,3068,p,0
220976,11,5,2,18,20,m,Michael.jpg,pieFS5.bmp,Michael just found $50 on the street,1,resources,185073,188501,3428,p,0
220976,12,5,2,18,20,m,Daniel.jpg,pieFS5.bmp,Daniel could not afford his mortgage and his home was foreclosed.,2,na,200705,203361,2656,p,0
220976,13,4,3,12,15,m,Paul.jpg,pieFS4.bmp,Paul is hiding his taxable income in Switzerland.,1,reputation,215589,217441,1852,p,0
220976,14,2,7,10,17,f,Deborah.jpg,pieFS2.bmp,Deborah takes discarded food from grocery stores to feed her children.,2,na,229656,232901,3245,q,1
220976,15,4,2,8,10,m,Edward.jpg,pieFS4.bmp,Edward underreports his company's earnings and pockets the profits.,1,reputation,245122,247161,2039,p,0
220976,16,4,1,4,5,m,Ben.jpg,pieFS4.bmp,Ben is homeless,2,na,259389,260521,1132,q,1
220976,17,4,3,12,15,f,Maria.jpg,pieFS4.bmp,Maria steals her coworkers' tips to buy alcohol.,1,reputation,272758,281488,8730,q,1
220976,18,2,6,9,15,m,Mark.jpg,pieFS2.bmp,Mark is saving to pay his university fees,2,na,293717,296581,2864,q,1
220976,19,3,4,9,13,m,Sam.jpg,pieFS3.bmp,Sam lives in a luxury penthouse apartment,1,resources,308817,311001,2184,q,1
220976,20,3,2,4,6,f,Mary.jpg,pieFS3.bmp,Mary can't afford to pay her medical bills,2,na,323218,324921,1703,q,1
220976,21,4,2,8,10,m,George.jpg,pieFS4.bmp,George is a well paid lawyer,1,resources,337152,338441,1289,p,0
220976,22,4,1,4,5,m,Jack.jpg,pieFS4.bmp,Jack stole money from his mother's wallet.,1,reputation,350670,353401,2731,p,0
220976,23,4,2,8,10,f,Arianna.jpg,pieFS4.bmp,Arianna is going to be evicted because she is behind on her rent,2,na,365620,367481,1861,q,1
220976,24,1,10,10,20,f,Emily.jpg,pieFS1.bmp,Emily just lost her small business after a franchise moved in next door.,2,na,379721,383301,3580,q,1
220976,25,5,2,18,20,f,Miriam.jpg,pieFS5.bmp,Miriam owns an international company,1,resources,395536,397461,1925,p,0
220976,26,3,5,11,16,f,Emma.jpg,pieFS3.bmp,Emma received a large inheritance from a distant relative,1,resources,409720,412262,2542,q,1
220976,27,1,8,8,16,m,Justin.jpg,pieFS1.bmp,Justin is a retiree,2,na,424504,427402,2898,q,1
220976,28,3,3,7,10,f,Jackie.jpg,pieFS3.bmp,Jackie used her mother's social security number to open a credit card account.,1,reputation,439637,444522,4885,p,0
220976,29,5,1,9,10,f,Monica.jpg,pieFS5.bmp,Monica is raising money to buy gifts for children in need.,2,na,456751,461502,4751,q,1
220976,30,3,3,7,10,f,Fay.jpg,pieFS3.bmp,Fay is a single mother,2,na,473715,476282,2567,q,1
220976,31,5,2,18,20,m,Darnell.jpg,pieFS5.bmp,Darnell lost his life savings when his small business failed,2,na,488515,491982,3467,q,1
220976,32,2,8,12,20,f,Lauren.jpg,pieFS2.bmp,Lauren illegally parks in the disabled parking spots when she can.,1,reputation,504197,507082,2885,q,1
220976,33,3,4,9,13,m,Tony.jpg,pieFS3.bmp,Tony cheated on his taxes and is now under investigation for tax fraud.,1,reputation,519297,522682,3385,p,0
220976,34,4,4,16,20,f,Beth.jpg,pieFS4.bmp,Beth just won the lottery,1,resources,534896,537062,2166,q,1
220976,35,3,6,14,20,m,Brad.jpg,pieFS3.bmp,Brad is a veteran having trouble finding employment.,2,na,549263,550342,1079,q,1
220976,36,5,1,9,10,f,Cindy.jpg,pieFS5.bmp,Cindy's car with her bag and credit cards was recently stolen.,2,na,562548,566362,3814,q,1
220976,37,3,2,4,6,f,Kay.jpg,pieFS3.bmp,Kay cannot afford to send her son to college.,2,na,578564,581062,2498,q,1
220976,38,4,2,8,10,f,Jean.jpg,pieFS4.bmp,Jean just found out that her husband has incurred a large credit card debt.,2,na,593264,596642,3378,q,1
220976,39,4,4,16,20,f,Sammy.jpg,pieFS4.bmp,Sammy is a highly paid actress,1,resources,608863,611562,2699,q,1
220976,40,3,3,7,10,m,Matt.jpg,pieFS3.bmp,Matt stole his elderly father's prescription medications.,1,reputation,623813,628202,4389,p,0
220976,41,5,1,9,10,f,Louise.jpg,pieFS5.bmp,Louise regularly fires employees to avoid promoting them.,1,reputation,640411,642363,1952,p,0
220976,42,5,1,9,10,f,Marny.jpg,pieFS5.bmp,Marny has to take an unpaid leave of absence because her mother broke her hip.,2,na,654595,656423,1828,q,1
220976,43,4,4,16,20,m,Don.jpg,pieFS4.bmp,Don declared bankruptcy after he was laid off.,2,na,668629,670783,2154,q,1
220976,44,5,1,9,10,m,Ricky.jpg,pieFS5.bmp,Ricky just bought an expensive sports car,1,resources,682996,684143,1147,p,0
220976,45,2,3,4,7,m,Jared.jpg,pieFS2.bmp,Jared is saving for his son's operation,2,na,696348,697303,955,q,1
220976,46,3,4,9,13,m,Peter.jpg,pieFS3.bmp,Peter takes valuables from his friends' homes when asked to house-sit.,1,reputation,709517,713103,3586,p,0
220976,47,5,1,9,10,m,Saul.jpg,pieFS5.bmp,Saul was injured in a hit-and-run accident and cannot afford his medical bills.,2,na,725332,726843,1511,q,1
220976,48,1,5,5,10,f,Eileen.jpg,pieFS1.bmp,Eileen got a large cash bonus from her boss,1,resources,739067,740663,1596,q,1
220976,49,2,3,4,7,f,Trish.jpg,pieFS2.bmp,Trish secretly gambles with her husband's savings.,1,reputation,752884,755703,2819,p,0
220976,50,2,6,9,15,m,Taymar.jpg,pieFS2.bmp,Taymar bullies his employees to put in extra hours at work.,1,reputation,767918,772303,4385,q,1
220976,51,5,1,9,10,m,Stuart.jpg,pieFS5.bmp,Stuart was mugged and had his wallet stolen.,2,na,784532,785843,1311,q,1
220976,52,1,9,9,18,m,Kevin.jpg,pieFS1.bmp,Kevin often goes through and steals the neighbors' mail.,1,reputation,798067,805563,7496,q,1
220989,1,5,1,9,10,m,Ian.jpg,pieFS5.bmp,Ian was injured in a hit-and-run accident and cannot afford his medical bills.,2,na,122351,123556,1205,q,1
220989,2,3,3,7,10,m,Ricky.jpg,pieFS3.bmp,Ricky is hiding his taxable income in Switzerland.,1,reputation,135778,136494,716,q,1
220989,3,5,2,18,20,m,Daniel.jpg,pieFS5.bmp,Daniel underreports his company's earnings and pockets the profits.,1,reputation,148669,149599,930,q,1
220989,4,5,2,18,20,m,Darnell.jpg,pieFS5.bmp,Darnell was mugged and had his wallet stolen.,2,na,161795,161877,82,q,1
220989,5,3,4,9,13,m,George.jpg,pieFS3.bmp,George is a well paid lawyer,1,resources,174068,174836,768,q,1
220989,6,3,2,4,6,f,Arianna.jpg,pieFS3.bmp,Arianna works as a cleaner in a hotel,2,na,187027,188035,1008,q,1
220989,7,4,3,12,15,f,Monica.jpg,pieFS4.bmp,Monica got a large cash bonus from her boss,1,resources,200237,201067,830,q,1
220989,8,3,4,9,13,m,Mark.jpg,pieFS3.bmp,Mark often goes through and steals the neighbors' mail.,1,reputation,213262,214941,1679,p,0
220989,9,4,3,12,15,m,Jared.jpg,pieFS4.bmp,Jared is a retiree,2,na,227124,227990,866,q,1
220989,10,4,4,16,20,f,Mary.jpg,pieFS4.bmp,Mary's husband is a wealthy investment banker,1,resources,240183,240975,792,q,1
220989,11,4,4,16,20,m,Peter.jpg,pieFS4.bmp,Peter has been unable to find a job for over a year.,2,na,253175,254022,847,q,1
220989,12,5,1,9,10,f,Marny.jpg,pieFS5.bmp,Marny was a victim of identity theft and is now thousands of dollars in debt.,2,na,266217,267027,810,p,0
220989,13,1,10,10,20,f,Jean.jpg,pieFS1.bmp,Jean works two waitressing jobs to pay her bills.,2,na,279226,280227,1001,q,1
220989,14,2,3,4,7,m,Ben.jpg,pieFS2.bmp,Ben lost his house in a fire,2,na,292435,293493,1058,q,1
220989,15,5,1,9,10,f,Cindy.jpg,pieFS5.bmp,Cindy just received a huge cash settlement,1,resources,305695,306635,940,q,1
220989,16,3,2,4,6,f,Lauren.jpg,pieFS3.bmp,Lauren takes discarded food from grocery stores to feed her children.,2,na,318854,319541,687,q,1
220989,17,4,2,8,10,m,Stuart.jpg,pieFS4.bmp,Stuart just found $50 on the street,1,resources,331730,332949,1219,q,1
220989,18,5,1,9,10,m,Matt.jpg,pieFS5.bmp,Matt is homeless,2,na,345156,346433,1277,q,1
220989,19,3,2,4,6,f,Louise.jpg,pieFS3.bmp,Louise can't afford to pay her medical bills,2,na,358633,359574,941,q,1
220989,20,2,7,10,17,f,Fay.jpg,pieFS2.bmp,Fay is going to be evicted because she is behind on her rent,2,na,371776,372560,784,q,1
220989,21,4,1,4,5,m,Brad.jpg,pieFS4.bmp,Brad is saving to pay his university fees,2,na,384751,385795,1044,q,1
220989,22,2,3,4,7,f,Fiona.jpg,pieFS2.bmp,Fiona owns an international company,1,resources,397994,399249,1255,q,1
220989,23,3,2,4,6,f,Sharon.jpg,pieFS3.bmp,Sharon received a large inheritance from a distant relative,1,resources,411404,412350,946,q,1
220989,24,4,2,8,10,m,Nick.jpg,pieFS4.bmp,Nick lives in a luxury penthouse apartment,1,resources,424547,425554,1007,q,1
220989,25,5,1,9,10,f,Kay.jpg,pieFS5.bmp,Kay is a single mother,2,na,437757,438961,1204,q,1
220989,26,1,5,5,10,f,Miriam.jpg,pieFS1.bmp,Miriam just won the lottery,1,resources,451150,452327,1177,q,1
220989,27,4,3,12,15,m,Jack.jpg,pieFS4.bmp,Jack stole money from his mother's wallet.,1,reputation,464510,465508,998,q,1
220989,28,5,1,9,10,m,Alan.jpg,pieFS5.bmp,Alan just bought an expensive sports car,1,resources,477703,478885,1182,q,1
220989,29,2,8,12,20,f,Kelly.jpg,pieFS2.bmp,Kelly steals her coworkers' tips to buy alcohol.,1,reputation,491063,491713,650,p,0
220989,30,5,2,18,20,m,Saul.jpg,pieFS5.bmp,Saul lost his life savings when his small business failed,2,na,503888,504807,919,q,1
220989,31,4,1,4,5,f,Emma.jpg,pieFS4.bmp,Emma cannot afford to send her son to college.,2,na,516997,518137,1140,q,1
220989,32,1,9,9,18,m,Michael.jpg,pieFS1.bmp,Michael cheated on his taxes and is now under investigation for tax fraud.,1,reputation,530323,531497,1174,p,0
220989,33,1,8,8,16,m,Sam.jpg,pieFS1.bmp,Sam is a veteran having trouble finding employment.,2,na,543700,544497,797,q,1
220989,34,3,6,14,20,m,Edward.jpg,pieFS3.bmp,Edward is saving for his son's operation,2,na,556692,557717,1025,q,1
220989,35,5,2,18,20,m,Don.jpg,pieFS5.bmp,Don stole his elderly father's prescription medications.,1,reputation,569902,571311,1409,p,0
220989,36,2,6,9,15,m,Kevin.jpg,pieFS2.bmp,Kevin declared bankruptcy after he was laid off.,2,na,583513,584530,1017,q,1
220989,37,4,2,8,10,f,Jackie.jpg,pieFS4.bmp,Jackie just lost her small business after a franchise moved in next door.,2,na,596722,598047,1325,q,1
220989,38,4,4,16,20,f,Emily.jpg,pieFS4.bmp,Emily used her mother's social security number to open a credit card account.,1,reputation,610232,611673,1441,q,1
220989,39,4,2,8,10,f,Maria.jpg,pieFS4.bmp,Maria is raising money to buy gifts for children in need.,2,na,623860,625001,1141,q,1
220989,40,4,1,4,5,m,Taymar.jpg,pieFS4.bmp,Taymar bullies his employees to put in extra hours at work.,1,reputation,637203,638580,1377,p,0
220989,41,5,2,18,20,f,Jenny.jpg,pieFS5.bmp,Jenny illegally parks in the disabled parking spots when she can.,1,reputation,650797,652175,1378,q,1
220989,42,3,5,11,16,m,Justin.jpg,pieFS3.bmp,Justin just lost his job,2,na,664375,665488,1113,q,1
220989,43,4,3,12,15,f,Deborah.jpg,pieFS4.bmp,Deborah's car with her bag and credit cards was recently stolen.,2,na,677685,678676,991,q,1
220989,44,5,1,9,10,f,Sammy.jpg,pieFS5.bmp,Sammy just found out that her husband has incurred a large credit card debt.,2,na,690877,692037,1160,q,1
220989,45,5,1,9,10,f,Eileen.jpg,pieFS5.bmp,Eileen is a highly paid actress,1,resources,704221,705006,785,q,1
220989,46,3,4,9,13,m,Joe.jpg,pieFS3.bmp,Joe employs illegal immigrants and pays them less than minimum wage.,1,reputation,717196,718725,1529,q,1
220989,47,3,5,11,16,f,Beth.jpg,pieFS3.bmp,Beth regularly fires employees to avoid promoting them.,1,reputation,730924,732601,1677,q,1
220989,48,2,6,9,15,m,Tony.jpg,pieFS2.bmp,Tony takes valuables from his friends' homes when asked to house-sit.,1,reputation,744802,745898,1096,p,0
220989,49,3,3,7,10,f,Joanna.jpg,pieFS3.bmp,Joanna has to take an unpaid leave of absence because her mother broke her hip.,2,na,758079,759024,945,q,1
220989,50,3,6,14,20,m,Paul.jpg,pieFS3.bmp,Paul could not afford his mortgage and his home was foreclosed.,2,na,771221,772150,929,q,1
220989,51,3,3,7,10,f,Trish.jpg,pieFS3.bmp,Trish secretly gambles with her husband's savings.,1,reputation,784347,785385,1038,p,0
220989,52,5,1,9,10,f,Janet.jpg,pieFS5.bmp,Janet claims false expenses for her reportable work travel.,1,reputation,797573,800698,3125,q,1
23260,1,1,9,9,18,m,Stuart.jpg,pieFS1.bmp,Stuart takes valuables from his friends' homes when asked to house-sit.,1,reputation,35054,40173,5119,p,0
23260,2,5,1,9,10,m,Edward.jpg,pieFS5.bmp,Edward underreports his company's earnings and pockets the profits.,1,reputation,52351,54754,2403,p,0
23260,3,4,1,4,5,m,Darnell.jpg,pieFS4.bmp,Darnell was injured in a hit-and-run accident and cannot afford his medical bills.,2,na,66952,69914,2962,q,1
23260,4,1,5,5,10,f,Jean.jpg,pieFS1.bmp,Jean just received a huge cash settlement,1,resources,82102,84735,2633,q,1
23260,5,5,1,9,10,m,Ian.jpg,pieFS5.bmp,Ian was mugged and had his wallet stolen.,2,na,96919,99735,2816,p,0
23260,6,1,10,10,20,f,Emily.jpg,pieFS1.bmp,Emily takes discarded food from grocery stores to feed her children.,2,na,111902,116155,4253,q,1
23260,7,3,3,7,10,f,Maria.jpg,pieFS3.bmp,Maria steals her coworkers' tips to buy alcohol.,1,reputation,128351,129436,1085,p,0
23260,8,3,4,9,13,m,Sam.jpg,pieFS3.bmp,Sam often goes through and steals the neighbors' mail.,1,reputation,141603,142496,893,p,0
23260,9,3,2,4,6,f,Jenny.jpg,pieFS3.bmp,Jenny just lost her small business after a franchise moved in next door.,2,na,154672,156837,2165,q,1
23260,10,3,6,14,20,m,Matt.jpg,pieFS3.bmp,Matt has been unable to find a job for over a year.,2,na,169006,173197,4191,q,1
23260,11,2,6,9,15,m,Kevin.jpg,pieFS2.bmp,Kevin lost his house in a fire,2,na,185355,188377,3022,q,1
23260,12,5,1,9,10,f,Louise.jpg,pieFS5.bmp,Louise is going to be evicted because she is behind on her rent,2,na,200538,202278,1740,q,1
23260,13,4,2,8,10,m,Tony.jpg,pieFS4.bmp,Tony just found $50 on the street,1,resources,214439,217218,2779,q,1
23260,14,3,2,4,6,f,Kay.jpg,pieFS3.bmp,Kay owns an international company,1,resources,229389,231539,2150,q,1
23260,15,3,4,9,13,m,Joe.jpg,pieFS3.bmp,Joe is a well paid lawyer,1,resources,243690,246239,2549,q,1
23260,16,4,3,12,15,f,Deborah.jpg,pieFS4.bmp,Deborah used her mother's social security number to open a credit card account.,1,reputation,258407,260199,1792,p,0
23260,17,2,3,4,7,m,Don.jpg,pieFS2.bmp,Don is homeless,2,na,272359,273620,1261,q,1
23260,18,5,1,9,10,m,Mark.jpg,pieFS5.bmp,Mark is saving to pay his university fees,2,na,285777,286600,823,q,1
23260,19,4,4,16,20,f,Janet.jpg,pieFS4.bmp,Janet received a large inheritance from a distant relative,1,resources,298746,299800,1054,q,1
23260,20,4,2,8,10,f,Joanna.jpg,pieFS4.bmp,Joanna is raising money to buy gifts for children in need.,2,na,311948,313001,1053,q,1
23260,21,4,1,4,5,f,Sharon.jpg,pieFS4.bmp,Sharon is a single mother,2,na,325151,326001,850,q,1
23260,22,5,2,18,20,m,Jared.jpg,pieFS5.bmp,Jared is a retiree,2,na,338153,339141,988,q,1
23260,23,5,2,18,20,m,Nick.jpg,pieFS5.bmp,Nick lives in a luxury penthouse apartment,1,resources,351288,353002,1714,q,1
23260,24,5,1,9,10,f,Cindy.jpg,pieFS5.bmp,Cindy illegally parks in the disabled parking spots when she can.,1,reputation,365173,366862,1689,p,0
23260,25,2,8,12,20,f,Arianna.jpg,pieFS2.bmp,Arianna just won the lottery,1,resources,379041,379902,861,q,1
23260,26,2,6,9,15,m,Brad.jpg,pieFS2.bmp,Brad stole money from his mother's wallet.,1,reputation,392093,392823,730,p,0
23260,27,3,2,4,6,f,Miriam.jpg,pieFS3.bmp,Miriam cannot afford to send her son to college.,2,na,404979,405503,524,q,1
23260,28,5,1,9,10,f,Lauren.jpg,pieFS5.bmp,Lauren's car with her bag and credit cards was recently stolen.,2,na,417665,418384,719,q,1
23260,29,4,2,8,10,f,Jackie.jpg,pieFS4.bmp,Jackie just found out that her husband has incurred a large credit card debt.,2,na,430551,431964,1413,q,1
23260,30,4,4,16,20,f,Fiona.jpg,pieFS4.bmp,Fiona regularly fires employees to avoid promoting them.,1,reputation,444136,444784,648,p,0
23260,31,4,1,4,5,m,Justin.jpg,pieFS4.bmp,Justin just bought an expensive sports car,1,resources,456972,457745,773,q,1
23260,32,3,5,11,16,m,Paul.jpg,pieFS3.bmp,Paul is saving for his son's operation,2,na,469891,470765,874,q,1
23260,33,3,3,7,10,m,Daniel.jpg,pieFS3.bmp,Daniel bullies his employees to put in extra hours at work.,1,reputation,482960,483545,585,p,0
23260,34,1,8,8,16,m,Jack.jpg,pieFS1.bmp,Jack lost his life savings when his small business failed,2,na,495746,496326,580,q,1
23260,35,2,3,4,7,f,Emma.jpg,pieFS2.bmp,Emma secretly gambles with her husband's savings.,1,reputation,508515,508986,471,p,0
23260,36,5,1,9,10,f,Sammy.jpg,pieFS5.bmp,Sammy is a highly paid actress,1,resources,521185,522046,861,q,1
23260,37,4,3,12,15,f,Kelly.jpg,pieFS4.bmp,Kelly has to take an unpaid leave of absence because her mother broke her hip.,2,na,534220,535027,807,q,1
23260,38,4,3,12,15,m,Taymar.jpg,pieFS4.bmp,Taymar just lost his job,2,na,547189,548047,858,q,1
23260,39,3,5,11,16,f,Monica.jpg,pieFS3.bmp,Monica got a large cash bonus from her boss,1,resources,560225,561047,822,q,1
23260,40,3,3,7,10,f,Eileen.jpg,pieFS3.bmp,Eileen was a victim of identity theft and is now thousands of dollars in debt.,2,na,573211,574168,957,q,1
23260,41,5,2,18,20,m,Michael.jpg,pieFS5.bmp,Michael cheated on his taxes and is now under investigation for tax fraud.,1,reputation,586346,587608,1262,p,0
23260,42,5,2,18,20,f,Trish.jpg,pieFS5.bmp,Trish claims false expenses for her reportable work travel.,1,reputation,599781,603229,3448,p,0
23260,43,3,2,4,6,f,Fay.jpg,pieFS3.bmp,Fay works as a cleaner in a hotel,2,na,615397,616169,772,q,1
23260,44,3,6,14,20,m,Peter.jpg,pieFS3.bmp,Peter is a veteran having trouble finding employment.,2,na,628366,629029,663,q,1
23260,45,3,4,9,13,m,Ben.jpg,pieFS3.bmp,Ben stole his elderly father's prescription medications.,1,reputation,641219,641809,590,p,0
23260,46,4,3,12,15,m,George.jpg,pieFS4.bmp,George employs illegal immigrants and pays them less than minimum wage.,1,reputation,653988,654970,982,p,0
23260,47,4,4,16,20,m,Ricky.jpg,pieFS4.bmp,Ricky could not afford his mortgage and his home was foreclosed.,2,na,667140,667710,570,q,1
23260,48,5,2,18,20,m,Saul.jpg,pieFS5.bmp,Saul declared bankruptcy after he was laid off.,2,na,679876,680411,535,q,1
23260,49,2,7,10,17,f,Marny.jpg,pieFS2.bmp,Marny works two waitressing jobs to pay her bills.,2,na,692562,693211,649,q,1
23260,50,5,1,9,10,f,Beth.jpg,pieFS5.bmp,Beth's husband is a wealthy investment banker,1,resources,705365,706371,1006,q,1
23260,51,4,2,8,10,m,Alan.jpg,pieFS4.bmp,Alan is hiding his taxable income in Switzerland.,1,reputation,718517,719072,555,p,0
23260,52,5,1,9,10,f,Mary.jpg,pieFS5.bmp,Mary can't afford to pay her medical bills,2,na,731220,732172,952,q,1
46069,1,5,1,9,10,f,Trish.jpg,pieFS5.bmp,Trish cannot afford to send her son to college.,2,na,103352,108960,5608,q,1
46069,2,4,1,4,5,f,Eileen.jpg,pieFS4.bmp,Eileen takes discarded food from grocery stores to feed her children.,2,na,121143,123541,2398,q,1
46069,3,5,1,9,10,m,Matt.jpg,pieFS5.bmp,Matt lives in a luxury penthouse apartment,1,resources,135690,138133,2443,q,1
46069,4,4,4,16,20,f,Jackie.jpg,pieFS4.bmp,Jackie steals her coworkers' tips to buy alcohol.,1,reputation,150288,154595,4307,q,1
46069,5,4,3,12,15,m,Michael.jpg,pieFS4.bmp,Michael stole money from his mother's wallet.,1,reputation,166774,169276,2502,q,1
46069,6,5,1,9,10,f,Marny.jpg,pieFS5.bmp,Marny just lost her small business after a franchise moved in next door.,2,na,181422,184196,2774,q,1
46069,7,4,3,12,15,m,Kevin.jpg,pieFS4.bmp,Kevin lost his life savings when his small business failed,2,na,196337,198581,2244,q,1
46069,8,3,3,7,10,f,Sammy.jpg,pieFS3.bmp,Sammy used her mother's social security number to open a credit card account.,1,reputation,210750,214181,3431,q,1
46069,9,2,6,9,15,m,Nick.jpg,pieFS2.bmp,Nick cheated on his taxes and is now under investigation for tax fraud.,1,reputation,226351,228524,2173,q,1
46069,10,3,3,7,10,m,George.jpg,pieFS3.bmp,George is hiding his taxable income in Switzerland.,1,reputation,240681,242356,1675,q,1
46069,11,3,2,4,6,f,Jean.jpg,pieFS3.bmp,Jean is raising money to buy gifts for children in need.,2,na,254542,260659,6117,p,0
46069,12,5,1,9,10,m,Mark.jpg,pieFS5.bmp,Mark is a veteran having trouble finding employment.,2,na,272852,275190,2338,q,1
46069,13,3,4,9,13,m,Paul.jpg,pieFS3.bmp,Paul underreports his company's earnings and pockets the profits.,1,reputation,287366,289253,1887,q,1
46069,14,5,1,9,10,f,Mary.jpg,pieFS5.bmp,Mary regularly fires employees to avoid promoting them.,1,reputation,301428,303029,1601,q,1
46069,15,5,1,9,10,f,Emma.jpg,pieFS5.bmp,Emma secretly gambles with her husband's savings.,1,reputation,315206,316514,1308,q,1
46069,16,3,4,9,13,m,Ben.jpg,pieFS3.bmp,Ben stole his elderly father's prescription medications.,1,reputation,328666,329883,1217,q,1
46069,17,1,8,8,16,m,Ian.jpg,pieFS1.bmp,Ian declared bankruptcy after he was laid off.,2,na,342060,343720,1660,q,1
46069,18,3,5,11,16,f,Fiona.jpg,pieFS3.bmp,Fiona claims false expenses for her reportable work travel.,1,reputation,355871,356750,879,q,1
46069,19,5,2,18,20,f,Joanna.jpg,pieFS5.bmp,Joanna illegally parks in the disabled parking spots when she can.,1,reputation,368930,370845,1915,q,1
46069,20,1,10,10,20,f,Cindy.jpg,pieFS1.bmp,Cindy's car with her bag and credit cards was recently stolen.,2,na,383026,384237,1211,q,1
46069,21,2,7,10,17,f,Arianna.jpg,pieFS2.bmp,Arianna works as a cleaner in a hotel,2,na,396386,397699,1313,q,1
46069,22,3,4,9,13,m,Justin.jpg,pieFS3.bmp,Justin is a well paid lawyer,1,resources,409879,410992,1113,q,1
46069,23,2,8,12,20,f,Kay.jpg,pieFS2.bmp,Kay's husband is a wealthy investment banker,1,resources,423156,424093,937,q,1
46069,24,3,2,4,6,f,Janet.jpg,pieFS3.bmp,Janet can't afford to pay her medical bills,2,na,436248,437485,1237,q,1
46069,25,2,3,4,7,m,Joe.jpg,pieFS2.bmp,Joe is a retiree,2,na,449658,450853,1195,q,1
46069,26,5,2,18,20,m,Tony.jpg,pieFS5.bmp,Tony takes valuables from his friends' homes when asked to house-sit.,1,reputation,463002,464240,1238,q,1
46069,27,4,3,12,15,f,Maria.jpg,pieFS4.bmp,Maria just found out that her husband has incurred a large credit card debt.,2,na,476412,477403,991,q,1
46069,28,2,3,4,7,f,Lauren.jpg,pieFS2.bmp,Lauren is a highly paid actress,1,resources,489571,490597,1026,q,1
46069,29,2,6,9,15,m,Jack.jpg,pieFS2.bmp,Jack was injured in a hit-and-run accident and cannot afford his medical bills.,2,na,502781,503970,1189,q,1
46069,30,3,2,4,6,f,Sharon.jpg,pieFS3.bmp,Sharon is going to be evicted because she is behind on her rent,2,na,516157,517451,1294,q,1
46069,31,3,5,11,16,m,Saul.jpg,pieFS3.bmp,Saul was mugged and had his wallet stolen.,2,na,529618,531175,1557,q,1
46069,32,4,1,4,5,m,Jared.jpg,pieFS4.bmp,Jared just bought an expensive sports car,1,resources,543312,544820,1508,q,1
46069,33,4,2,8,10,m,Darnell.jpg,pieFS4.bmp,Darnell often goes through and steals the neighbors' mail.,1,reputation,556990,557968,978,q,1
46069,34,3,6,14,20,m,Taymar.jpg,pieFS3.bmp,Taymar is saving for his son's operation,2,na,570116,571467,1351,q,1
46069,35,3,2,4,6,f,Louise.jpg,pieFS3.bmp,Louise owns an international company,1,resources,583643,585154,1511,q,1
46069,36,4,2,8,10,f,Kelly.jpg,pieFS4.bmp,Kelly has to take an unpaid leave of absence because her mother broke her hip.,2,na,597337,598804,1467,q,1
46069,37,4,3,12,15,f,Deborah.jpg,pieFS4.bmp,Deborah got a large cash bonus from her boss,1,resources,610965,611980,1015,q,1
46069,38,4,2,8,10,f,Monica.jpg,pieFS4.bmp,Monica was a victim of identity theft and is now thousands of dollars in debt.,2,na,624158,624322,164,q,1
46069,39,1,5,5,10,f,Beth.jpg,pieFS1.bmp,Beth received a large inheritance from a distant relative,1,resources,636481,637896,1415,q,1
46069,40,5,2,18,20,m,Sam.jpg,pieFS5.bmp,Sam has been unable to find a job for over a year.,2,na,650092,650946,854,q,1
46069,41,5,1,9,10,f,Fay.jpg,pieFS5.bmp,Fay is a single mother,2,na,663117,664160,1043,q,1
46069,42,4,1,4,5,m,Stuart.jpg,pieFS4.bmp,Stuart lost his house in a fire,2,na,676327,677064,737,q,1
46069,43,5,2,18,20,m,Daniel.jpg,pieFS5.bmp,Daniel bullies his employees to put in extra hours at work.,1,reputation,689235,690338,1103,q,1
46069,44,5,1,9,10,m,Alan.jpg,pieFS5.bmp,Alan just lost his job,2,na,702512,703575,1063,q,1
46069,45,1,9,9,18,m,Ricky.jpg,pieFS1.bmp,Ricky employs illegal immigrants and pays them less than minimum wage.,1,reputation,715755,717000,1245,q,1
46069,46,3,3,7,10,f,Emily.jpg,pieFS3.bmp,Emily works two waitressing jobs to pay her bills.,2,na,729182,730270,1088,q,1
46069,47,5,2,18,20,m,Edward.jpg,pieFS5.bmp,Edward could not afford his mortgage and his home was foreclosed.,2,na,742424,743624,1200,q,1
46069,48,5,1,9,10,f,Jenny.jpg,pieFS5.bmp,Jenny just received a huge cash settlement,1,resources,755768,758998,3230,q,1
46069,49,4,4,16,20,f,Miriam.jpg,pieFS4.bmp,Miriam just won the lottery,1,resources,771151,772010,859,q,1
46069,50,4,2,8,10,m,Brad.jpg,pieFS4.bmp,Brad just found $50 on the street,1,resources,784177,785036,859,q,1
46069,51,3,6,14,20,m,Don.jpg,pieFS3.bmp,Don is homeless,2,na,797185,798241,1056,q,1
46069,52,4,4,16,20,m,Peter.jpg,pieFS4.bmp,Peter is saving to pay his university fees,2,na,810412,811309,897,q,1
881106,1,4,2,8,10,f,Jackie.jpg,pieFS4.bmp,Jackie just found out that her husband has incurred a large credit card debt.,2,na,61640,65872,4232,q,1
881106,2,5,1,9,10,m,Justin.jpg,pieFS5.bmp,Justin just lost his job,2,na,78071,80092,2021,q,1
881106,3,3,4,9,13,m,Darnell.jpg,pieFS3.bmp,Darnell just found $50 on the street,1,resources,92288,93733,1445,q,1
881106,4,1,8,8,16,m,Jack.jpg,pieFS1.bmp,Jack is homeless,2,na,105906,107793,1887,q,1
881106,5,5,2,18,20,m,Peter.jpg,pieFS5.bmp,Peter is saving to pay his university fees,2,na,119991,121393,1402,q,1
881106,6,4,3,12,15,f,Louise.jpg,pieFS4.bmp,Louise's husband is a wealthy investment banker,1,resources,133592,135753,2161,q,1
881106,7,2,7,10,17,f,Emma.jpg,pieFS2.bmp,Emma can't afford to pay her medical bills,2,na,147943,149673,1730,q,1
881106,8,3,2,4,6,f,Fay.jpg,pieFS3.bmp,Fay is going to be evicted because she is behind on her rent,2,na,161860,163313,1453,q,1
881106,9,3,3,7,10,f,Janet.jpg,pieFS3.bmp,Janet owns an international company,1,resources,175511,176793,1282,q,1
881106,10,2,6,9,15,m,Mark.jpg,pieFS2.bmp,Mark lives in a luxury penthouse apartment,1,resources,188996,190253,1257,q,1
881106,11,5,2,18,20,f,Jenny.jpg,pieFS5.bmp,Jenny is a highly paid actress,1,resources,202448,203393,945,q,1
881106,12,3,4,9,13,m,Ricky.jpg,pieFS3.bmp,Ricky employs illegal immigrants and pays them less than minimum wage.,1,reputation,215583,216853,1270,q,1
881106,13,4,4,16,20,m,Edward.jpg,pieFS4.bmp,Edward could not afford his mortgage and his home was foreclosed.,2,na,229035,231313,2278,q,1
881106,14,5,1,9,10,f,Emily.jpg,pieFS5.bmp,Emily has to take an unpaid leave of absence because her mother broke her hip.,2,na,243485,245673,2188,q,1
881106,15,5,1,9,10,f,Eileen.jpg,pieFS5.bmp,Eileen got a large cash bonus from her boss,1,resources,257869,259813,1944,q,1
881106,16,2,8,12,20,f,Miriam.jpg,pieFS2.bmp,Miriam received a large inheritance from a distant relative,1,resources,271986,273893,1907,q,1
881106,17,4,2,8,10,m,Daniel.jpg,pieFS4.bmp,Daniel is hiding his taxable income in Switzerland.,1,reputation,286087,288613,2526,q,1
881106,18,5,1,9,10,f,Fiona.jpg,pieFS5.bmp,Fiona is a single mother,2,na,300804,304033,3229,q,1
881106,19,1,5,5,10,f,Sharon.jpg,pieFS1.bmp,Sharon just won the lottery,1,resources,316237,317613,1376,q,1
881106,20,4,2,8,10,f,Lauren.jpg,pieFS4.bmp,Lauren was a victim of identity theft and is now thousands of dollars in debt.,2,na,329805,331493,1688,q,1
881106,21,5,2,18,20,m,Alan.jpg,pieFS5.bmp,Alan underreports his company's earnings and pockets the profits.,1,reputation,343689,344973,1284,q,1
881106,22,3,3,7,10,f,Beth.jpg,pieFS3.bmp,Beth cannot afford to send her son to college.,2,na,357174,358333,1159,q,1
881106,23,5,2,18,20,m,Saul.jpg,pieFS5.bmp,Saul stole money from his mother's wallet.,1,reputation,370526,371933,1407,q,1
881106,24,4,3,12,15,m,George.jpg,pieFS4.bmp,George is a well paid lawyer,1,resources,384127,385073,946,q,1
881106,25,5,1,9,10,f,Cindy.jpg,pieFS5.bmp,Cindy works two waitressing jobs to pay her bills.,2,na,397262,398254,992,q,1
881106,26,5,1,9,10,f,Trish.jpg,pieFS5.bmp,Trish regularly fires employees to avoid promoting them.,1,reputation,410447,411474,1027,q,1
881106,27,4,3,12,15,m,Stuart.jpg,pieFS4.bmp,Stuart lost his life savings when his small business failed,2,na,423666,425314,1648,q,1
881106,28,3,3,7,10,m,Kevin.jpg,pieFS3.bmp,Kevin cheated on his taxes and is now under investigation for tax fraud.,1,reputation,437500,438514,1014,q,1
881106,29,4,4,16,20,f,Kay.jpg,pieFS4.bmp,Kay secretly gambles with her husband's savings.,1,reputation,450702,451594,892,q,1
881106,30,3,2,4,6,f,Monica.jpg,pieFS3.bmp,Monica just received a huge cash settlement,1,resources,463787,464934,1147,q,1
881106,31,5,1,9,10,m,Jared.jpg,pieFS5.bmp,Jared is a retiree,2,na,477122,477934,812,q,1
881106,32,1,10,10,20,f,Deborah.jpg,pieFS1.bmp,Deborah takes discarded food from grocery stores to feed her children.,2,na,490124,490974,850,q,1
881106,33,5,1,9,10,f,Kelly.jpg,pieFS5.bmp,Kelly steals her coworkers' tips to buy alcohol.,1,reputation,503176,505574,2398,q,1
881106,34,4,1,4,5,m,Joe.jpg,pieFS4.bmp,Joe just bought an expensive sports car,1,resources,517760,519454,1694,q,1
881106,35,3,2,4,6,f,Jean.jpg,pieFS3.bmp,Jean just lost her small business after a franchise moved in next door.,2,na,531644,532834,1190,q,1
881106,36,2,3,4,7,f,Marny.jpg,pieFS2.bmp,Marny used her mother's social security number to open a credit card account.,1,reputation,545046,546234,1188,q,1
881106,37,3,2,4,6,f,Sammy.jpg,pieFS3.bmp,Sammy is raising money to buy gifts for children in need.,2,na,558431,559454,1023,q,1
881106,38,3,6,14,20,m,Brad.jpg,pieFS3.bmp,Brad is a veteran having trouble finding employment.,2,na,571649,572434,785,q,1
881106,39,1,9,9,18,m,Michael.jpg,pieFS1.bmp,Michael stole his elderly father's prescription medications.,1,reputation,584618,585474,856,q,1
881106,40,3,5,11,16,m,Ian.jpg,pieFS3.bmp,Ian declared bankruptcy after he was laid off.,2,na,597670,598794,1124,q,1
881106,41,4,4,16,20,f,Joanna.jpg,pieFS4.bmp,Joanna illegally parks in the disabled parking spots when she can.,1,reputation,610989,612914,1925,q,1
881106,42,5,1,9,10,m,Matt.jpg,pieFS5.bmp,Matt takes valuables from his friends' homes when asked to house-sit.,1,reputation,625106,625634,528,q,1
881106,43,3,5,11,16,f,Mary.jpg,pieFS3.bmp,Mary claims false expenses for her reportable work travel.,1,reputation,637825,639894,2069,q,1
881106,44,5,2,18,20,m,Nick.jpg,pieFS5.bmp,Nick was injured in a hit-and-run accident and cannot afford his medical bills.,2,na,652092,653754,1662,q,1
881106,45,2,6,9,15,m,Don.jpg,pieFS2.bmp,Don was mugged and had his wallet stolen.,2,na,665943,667474,1531,q,1
881106,46,4,3,12,15,f,Maria.jpg,pieFS4.bmp,Maria's car with her bag and credit cards was recently stolen.,2,na,679661,680114,453,q,1
881106,47,3,4,9,13,m,Tony.jpg,pieFS3.bmp,Tony often goes through and steals the neighbors' mail.,1,reputation,692314,693534,1220,q,1
881106,48,2,3,4,7,m,Ben.jpg,pieFS2.bmp,Ben has been unable to find a job for over a year.,2,na,705732,708374,2642,q,1
881106,49,4,1,4,5,m,Paul.jpg,pieFS4.bmp,Paul is saving for his son's operation,2,na,720565,722234,1669,q,1
881106,50,3,6,14,20,m,Sam.jpg,pieFS3.bmp,Sam lost his house in a fire,2,na,734433,735454,1021,q,1
881106,51,4,1,4,5,f,Arianna.jpg,pieFS4.bmp,Arianna works as a cleaner in a hotel,2,na,747651,748615,964,q,1
881106,52,4,2,8,10,m,Taymar.jpg,pieFS4.bmp,Taymar bullies his employees to put in extra hours at work.,1,reputation,760803,762215,1412,q,1
881132,1,2,6,9,15,m,Michael.jpg,pieFS2.bmp,Michael takes valuables from his friends' homes when asked to house-sit.,1,reputation,66612,69458,2846,p,0
881132,2,2,3,4,7,m,Taymar.jpg,pieFS2.bmp,Taymar is a retiree,2,na,81644,85537,3893,q,1
881132,3,3,3,7,10,f,Sammy.jpg,pieFS3.bmp,Sammy illegally parks in the disabled parking spots when she can.,1,reputation,97729,99631,1902,p,0
881132,4,3,6,14,20,m,Tony.jpg,pieFS3.bmp,Tony was injured in a hit-and-run accident and cannot afford his medical bills.,2,na,111825,114351,2526,q,1
881132,5,4,2,8,10,m,Joe.jpg,pieFS4.bmp,Joe just bought an expensive sports car,1,resources,126539,128555,2016,q,1
881132,6,4,1,4,5,f,Fiona.jpg,pieFS4.bmp,Fiona is going to be evicted because she is behind on her rent,2,na,140752,142816,2064,q,1
881132,7,5,2,18,20,m,Ricky.jpg,pieFS5.bmp,Ricky is saving for his son's operation,2,na,155032,157228,2196,q,1
881132,8,3,5,11,16,m,Darnell.jpg,pieFS3.bmp,Darnell was mugged and had his wallet stolen.,2,na,169412,170932,1520,q,1
881132,9,3,3,7,10,f,Eileen.jpg,pieFS3.bmp,Eileen's car with her bag and credit cards was recently stolen.,2,na,183139,185276,2137,q,1
881132,10,3,4,9,13,m,Stuart.jpg,pieFS3.bmp,Stuart often goes through and steals the neighbors' mail.,1,reputation,197469,199007,1538,p,0
881132,11,5,2,18,20,f,Fay.jpg,pieFS5.bmp,Fay owns an international company,1,resources,211180,215371,4191,p,0
881132,12,4,4,16,20,m,Don.jpg,pieFS4.bmp,Don has been unable to find a job for over a year.,2,na,227567,229341,1774,q,1
881132,13,5,1,9,10,m,Kevin.jpg,pieFS5.bmp,Kevin lost his house in a fire,2,na,241512,243888,2376,q,1
881132,14,5,2,18,20,m,Jared.jpg,pieFS5.bmp,Jared bullies his employees to put in extra hours at work.,1,reputation,256092,257411,1319,p,0
881132,15,3,2,4,6,f,Jackie.jpg,pieFS3.bmp,Jackie just found out that her husband has incurred a large credit card debt.,2,na,269586,271030,1444,q,1
881132,16,5,1,9,10,m,Edward.jpg,pieFS5.bmp,Edward just lost his job,2,na,283214,285344,2130,q,1
881132,17,3,3,7,10,m,Ian.jpg,pieFS3.bmp,Ian just found $50 on the street,1,resources,297543,302938,5395,p,0
881132,18,4,4,16,20,f,Jean.jpg,pieFS4.bmp,Jean is a highly paid actress,1,resources,315134,317334,2200,q,1
881132,19,3,5,11,16,f,Trish.jpg,pieFS3.bmp,Trish received a large inheritance from a distant relative,1,resources,329530,331471,1941,q,1
881132,20,2,7,10,17,f,Kay.jpg,pieFS2.bmp,Kay is a single mother,2,na,343643,346487,2844,q,1
881132,21,5,2,18,20,m,Jack.jpg,pieFS5.bmp,Jack is homeless,2,na,358691,361863,3172,q,1
881132,22,5,2,18,20,m,Justin.jpg,pieFS5.bmp,Justin employs illegal immigrants and pays them less than minimum wage.,1,reputation,374058,375682,1624,p,0
881132,23,4,2,8,10,f,Jenny.jpg,pieFS4.bmp,Jenny has to take an unpaid leave of absence because her mother broke her hip.,2,na,387869,389708,1839,q,1
881132,24,3,6,14,20,m,Ben.jpg,pieFS3.bmp,Ben is saving to pay his university fees,2,na,401898,404865,2967,q,1
881132,25,4,1,4,5,m,Alan.jpg,pieFS4.bmp,Alan could not afford his mortgage and his home was foreclosed.,2,na,417064,418834,1770,q,1
881132,26,5,1,9,10,m,Matt.jpg,pieFS5.bmp,Matt lives in a luxury penthouse apartment,1,resources,431026,435229,4203,p,0
881132,27,1,9,9,18,m,Sam.jpg,pieFS1.bmp,Sam stole money from his mother's wallet.,1,reputation,447446,449804,2358,p,0
881132,28,5,1,9,10,f,Lauren.jpg,pieFS5.bmp,Lauren got a large cash bonus from her boss,1,resources,461993,471165,9172,p,0
881132,29,3,2,4,6,f,Joanna.jpg,pieFS3.bmp,Joanna was a victim of identity theft and is now thousands of dollars in debt.,2,na,483362,485244,1882,q,1
881132,30,4,3,12,15,m,Mark.jpg,pieFS4.bmp,Mark lost his life savings when his small business failed,2,na,497441,499916,2475,q,1
881132,31,4,3,12,15,f,Arianna.jpg,pieFS4.bmp,Arianna just won the lottery,1,resources,512122,514183,2061,q,1
881132,32,5,1,9,10,f,Miriam.jpg,pieFS5.bmp,Miriam cannot afford to send her son to college.,2,na,526368,532558,6190,q,1
881132,33,2,3,4,7,f,Louise.jpg,pieFS2.bmp,Louise regularly fires employees to avoid promoting them.,1,reputation,544744,548028,3284,p,0
881132,34,2,8,12,20,f,Emma.jpg,pieFS2.bmp,Emma secretly gambles with her husband's savings.,1,reputation,560211,562276,2065,p,0
881132,35,4,2,8,10,m,George.jpg,pieFS4.bmp,George is hiding his taxable income in Switzerland.,1,reputation,574474,576389,1915,p,0
881132,36,3,4,9,13,m,Brad.jpg,pieFS3.bmp,Brad cheated on his taxes and is now under investigation for tax fraud.,1,reputation,588569,591233,2664,p,0
881132,37,2,6,9,15,m,Peter.jpg,pieFS2.bmp,Peter is a veteran having trouble finding employment.,2,na,603434,605375,1941,q,1
881132,38,5,1,9,10,f,Kelly.jpg,pieFS5.bmp,Kelly works two waitressing jobs to pay her bills.,2,na,617563,619722,2159,q,1
881132,39,1,5,5,10,f,Marny.jpg,pieFS1.bmp,Marny just received a huge cash settlement,1,resources,631910,633813,1903,q,1
881132,40,4,3,12,15,m,Nick.jpg,pieFS4.bmp,Nick stole his elderly father's prescription medications.,1,reputation,646005,647830,1825,p,0
881132,41,5,1,9,10,f,Sharon.jpg,pieFS5.bmp,Sharon claims false expenses for her reportable work travel.,1,reputation,660051,661987,1936,p,0
881132,42,4,2,8,10,f,Monica.jpg,pieFS4.bmp,Monica takes discarded food from grocery stores to feed her children.,2,na,674180,676139,1959,q,1
881132,43,3,2,4,6,f,Mary.jpg,pieFS3.bmp,Mary works as a cleaner in a hotel,2,na,688342,690457,2115,q,1
881132,44,5,1,9,10,f,Maria.jpg,pieFS5.bmp,Maria steals her coworkers' tips to buy alcohol.,1,reputation,702622,704488,1866,p,0
881132,45,4,4,16,20,f,Beth.jpg,pieFS4.bmp,Beth's husband is a wealthy investment banker,1,resources,716668,719536,2868,q,1
881132,46,1,8,8,16,m,Saul.jpg,pieFS1.bmp,Saul declared bankruptcy after he was laid off.,2,na,731733,734055,2322,q,1
881132,47,3,4,9,13,m,Paul.jpg,pieFS3.bmp,Paul underreports his company's earnings and pockets the profits.,1,reputation,746247,749507,3260,p,0
881132,48,4,3,12,15,f,Janet.jpg,pieFS4.bmp,Janet can't afford to pay her medical bills,2,na,761697,767226,5529,q,1
881132,49,1,10,10,20,f,Cindy.jpg,pieFS1.bmp,Cindy just lost her small business after a franchise moved in next door.,2,na,779421,782055,2634,q,1
881132,50,3,2,4,6,f,Deborah.jpg,pieFS3.bmp,Deborah used her mother's social security number to open a credit card account.,1,reputation,794252,796022,1770,p,0
881132,51,5,1,9,10,f,Emily.jpg,pieFS5.bmp,Emily is raising money to buy gifts for children in need.,2,na,808197,811447,3250,p,0
881132,52,4,1,4,5,m,Daniel.jpg,pieFS4.bmp,Daniel is a well paid lawyer,1,resources,823647,825588,1941,q,1
881230,1,4,3,12,15,f,Cindy.jpg,pieFS4.bmp,Cindy illegally parks in the disabled parking spots when she can.,1,reputation,51631,55551,3920,z,1
881230,2,5,1,9,10,f,Kelly.jpg,pieFS5.bmp,Kelly's car with her bag and credit cards was recently stolen.,2,na,67666,69855,2189,z,1
881230,3,5,1,9,10,f,Monica.jpg,pieFS5.bmp,Monica just found out that her husband has incurred a large credit card debt.,2,na,81946,84903,2957,z,1
881230,4,5,1,9,10,f,Arianna.jpg,pieFS5.bmp,Arianna received a large inheritance from a distant relative,1,resources,96995,98841,1846,m,0
881230,5,3,2,4,6,f,Emma.jpg,pieFS3.bmp,Emma is a single mother,2,na,110940,113336,2396,z,1
881230,6,4,1,4,5,m,Sam.jpg,pieFS4.bmp,Sam was mugged and had his wallet stolen.,2,na,125437,127905,2468,m,0
881230,7,1,5,5,10,f,Lauren.jpg,pieFS1.bmp,Lauren is a highly paid actress,1,resources,140017,142031,2014,z,1
881230,8,4,2,8,10,f,Maria.jpg,pieFS4.bmp,Maria has to take an unpaid leave of absence because her mother broke her hip.,2,na,154130,156172,2042,z,1
881230,9,3,3,7,10,m,Paul.jpg,pieFS3.bmp,Paul underreports his company's earnings and pockets the profits.,1,reputation,168259,170784,2525,z,1
881230,10,5,2,18,20,m,Stuart.jpg,pieFS5.bmp,Stuart often goes through and steals the neighbors' mail.,1,reputation,182873,184986,2113,m,0
881230,11,1,9,9,18,m,Edward.jpg,pieFS1.bmp,Edward is a well paid lawyer,1,resources,197086,199987,2901,z,1
881230,12,3,2,4,6,f,Jean.jpg,pieFS3.bmp,Jean got a large cash bonus from her boss,1,resources,212084,213925,1841,z,1
881230,13,5,1,9,10,m,Daniel.jpg,pieFS5.bmp,Daniel is a retiree,2,na,225996,228682,2686,m,0
881230,14,2,8,12,20,f,Janet.jpg,pieFS2.bmp,Janet just won the lottery,1,resources,240794,243036,2242,z,1
881230,15,4,3,12,15,m,Justin.jpg,pieFS4.bmp,Justin just bought an expensive sports car,1,resources,255107,258428,3321,z,1
881230,16,4,1,4,5,f,Marny.jpg,pieFS4.bmp,Marny was a victim of identity theft and is now thousands of dollars in debt.,2,na,270524,272772,2248,z,1
881230,17,4,4,16,20,m,George.jpg,pieFS4.bmp,George is saving for his son's operation,2,na,284871,286976,2105,z,1
881230,18,3,5,11,16,m,Peter.jpg,pieFS3.bmp,Peter has been unable to find a job for over a year.,2,na,299067,301477,2410,z,1
881230,19,5,2,18,20,m,Matt.jpg,pieFS5.bmp,Matt lost his house in a fire,2,na,313564,315243,1679,z,1
881230,20,1,10,10,20,f,Emily.jpg,pieFS1.bmp,Emily works two waitressing jobs to pay her bills.,2,na,327342,329384,2042,z,1
881230,21,4,3,12,15,f,Mary.jpg,pieFS4.bmp,Mary cannot afford to send her son to college.,2,na,341471,343323,1852,z,1
881230,22,3,5,11,16,f,Fay.jpg,pieFS3.bmp,Fay regularly fires employees to avoid promoting them.,1,reputation,355416,358503,3087,z,1
881230,23,4,2,8,10,m,Kevin.jpg,pieFS4.bmp,Kevin just found $50 on the street,1,resources,370599,372559,1960,m,0
881230,24,5,1,9,10,m,Brad.jpg,pieFS5.bmp,Brad is homeless,2,na,384627,387090,2463,z,1
881230,25,4,4,16,20,f,Eileen.jpg,pieFS4.bmp,Eileen just received a huge cash settlement,1,resources,399191,401029,1838,z,1
881230,26,5,1,9,10,f,Deborah.jpg,pieFS5.bmp,Deborah takes discarded food from grocery stores to feed her children.,2,na,413120,414901,1781,z,1
881230,27,5,1,9,10,f,Trish.jpg,pieFS5.bmp,Trish secretly gambles with her husband's savings.,1,reputation,426981,429296,2315,m,0
881230,28,5,2,18,20,f,Jenny.jpg,pieFS5.bmp,Jenny steals her coworkers' tips to buy alcohol.,1,reputation,441395,443562,2167,m,0
881230,29,4,3,12,15,m,Don.jpg,pieFS4.bmp,Don is saving to pay his university fees,2,na,455658,458251,2593,z,1
881230,30,5,1,9,10,f,Sharon.jpg,pieFS5.bmp,Sharon claims false expenses for her reportable work travel.,1,reputation,470339,472086,1747,m,0
881230,31,3,3,7,10,f,Louise.jpg,pieFS3.bmp,Louise works as a cleaner in a hotel,2,na,484184,486143,1959,z,1
881230,32,2,7,10,17,f,Joanna.jpg,pieFS2.bmp,Joanna just lost her small business after a franchise moved in next door.,2,na,498246,500112,1866,z,1
881230,33,3,3,7,10,f,Fiona.jpg,pieFS3.bmp,Fiona's husband is a wealthy investment banker,1,resources,512208,514832,2624,z,1
881230,34,4,2,8,10,m,Jared.jpg,pieFS4.bmp,Jared bullies his employees to put in extra hours at work.,1,reputation,526922,529421,2499,m,0
881230,35,2,6,9,15,m,Ben.jpg,pieFS2.bmp,Ben lives in a luxury penthouse apartment,1,resources,541520,544411,2891,z,1
881230,36,3,2,4,6,f,Beth.jpg,pieFS3.bmp,Beth can't afford to pay her medical bills,2,na,556502,558771,2269,z,1
881230,37,2,3,4,7,f,Jackie.jpg,pieFS2.bmp,Jackie used her mother's social security number to open a credit card account.,1,reputation,570865,573647,2782,m,0
881230,38,5,2,18,20,m,Ricky.jpg,pieFS5.bmp,Ricky just lost his job,2,na,585746,589157,3411,z,1
881230,39,3,4,9,13,m,Nick.jpg,pieFS3.bmp,Nick stole money from his mother's wallet.,1,reputation,601247,603274,2027,m,0
881230,40,2,6,9,15,m,Tony.jpg,pieFS2.bmp,Tony lost his life savings when his small business failed,2,na,615359,617649,2290,z,1
881230,41,4,2,8,10,f,Miriam.jpg,pieFS4.bmp,Miriam is going to be evicted because she is behind on her rent,2,na,629739,631728,1989,z,1
881230,42,5,2,18,20,m,Jack.jpg,pieFS5.bmp,Jack cheated on his taxes and is now under investigation for tax fraud.,1,reputation,643818,646026,2208,m,0
881230,43,3,2,4,6,f,Sammy.jpg,pieFS3.bmp,Sammy is raising money to buy gifts for children in need.,2,na,658114,660417,2303,z,1
881230,44,3,6,14,20,m,Darnell.jpg,pieFS3.bmp,Darnell is a veteran having trouble finding employment.,2,na,672494,674324,1830,z,1
881230,45,4,4,16,20,f,Kay.jpg,pieFS4.bmp,Kay owns an international company,1,resources,686423,688856,2433,z,1
881230,46,5,1,9,10,m,Ian.jpg,pieFS5.bmp,Ian stole his elderly father's prescription medications.,1,reputation,700953,702888,1935,m,0
881230,47,1,8,8,16,m,Mark.jpg,pieFS1.bmp,Mark declared bankruptcy after he was laid off.,2,na,714966,718602,3636,z,1
881230,48,3,4,9,13,m,Saul.jpg,pieFS3.bmp,Saul takes valuables from his friends' homes when asked to house-sit.,1,reputation,730700,732921,2221,z,1
881230,49,4,1,4,5,m,Taymar.jpg,pieFS4.bmp,Taymar employs illegal immigrants and pays them less than minimum wage.,1,reputation,745013,746828,1815,m,0
881230,50,2,3,4,7,m,Joe.jpg,pieFS2.bmp,Joe could not afford his mortgage and his home was foreclosed.,2,na,758941,761610,2669,z,1
881230,51,3,6,14,20,m,Michael.jpg,pieFS3.bmp,Michael was injured in a hit-and-run accident and cannot afford his medical bills.,2,na,773706,775431,1725,z,1
881230,52,3,4,9,13,m,Alan.jpg,pieFS3.bmp,Alan is hiding his taxable income in Switzerland.,1,reputation,787534,789721,2187,z,1
